-------------------------
-------------------------
-------------------------
-------------------------
-------------------------
---------XX--------------
--------XXX--------------
-------XXXX------X------X
------XXXXX-----XX-----XX
------XXXXX-----XX-----XX
----XXXXXXX---XXXX---XXXX
---XXXXXXXX--XXXXX--XXXXX
------XXXXX-----XX-----XX
XXXXXXXXXXXXXXXXXXXXXXXXX