-------------------------
-------------------------
-------------------------
-------------------------
-------------------------
-------------------------
-------------------------
-------------------------
-------------E-----------
------------<>----E------
SS----------[]---<>------
------------[]---[]----E-
------E-EE-E[]---[]-E----
---XXXXXXXXXXXXXXXXXXX-X-