-------------------------
-------------------------
-------------------------
-------------------------
-------------------------
-------S-----------------
-------------------------
-------------------------
------E-EE-------------X-
----------XX-XX-------XX-
----------XX-XX------XXX-
----------XX-XX-----XXXX-
----------X--XX----XXXXX-
XXXX------X--XX--XXXXXXXX