-------------------------
-------------------------
-------------------------
-------------------------
-------------------------
----------SSSSSSS--------
-------------------------
-------------------------
-SQ----------------------
-------------------------
-------------------------
-------------------------
-SSSSS-------------------
-----XX-XXXX------X-XX---