-------------------------
-------------------------
-------------------------
-------------------------
-------------------------
-------S-----------S-----
-------------------------
-------------------------
------E-EE-------------E-
----------XX-X-----S--<>-
----------XX-X--------[]-
----------XX-X--------[]-
----------X--X-------E[]-
--XX------X--X--XXXXXXXXX