-------------------------
-------------------------
-------------------------
-------------------------
-------------------------
----------XXX-----S------
---------XXXX------------
--------XXXXX------------
-------XXXXXX------------
-------XXXXXX-----S-----X
-----XXXXXXXX----------XX
----XXXXXXXXX---X-----XXX
-------XXXXXX---X----XXXX
--XXXXXXXXXXXXXXXXXXXXXXX