-------------------------
-------------------------
-------------------------
-------------------------
-------------------------
-------------------------
-------------------------
-------------------------
-------------------------
----Q--------------------
-------------------------
-------------------------
----E---------------X----
--XXXXXXXXXXXXXXXXXXXXXXX