-------------------------
-------------------------
-------------------------
-------------------------
-------------------------
----------SS-------------
-------------------------
-------------------------
-------------------------
-------E------S----------
------<>-----------------
------[]-----------------
------[]-----------------
--XXXXXXXXXXXXXXXXXXXXXXX