-------------------------
-------------------------
-------------------------
-------------------------
-------------------------
------------QQQQ---------
-------------------------
-------------------------
-------------------------
--X-------QQ?SSQQQQ------
-XX----------------------
XXX----------------------
XXX-------------------E--
XXXXXXXXXXXXX--XXXXXXXXXX