-------------------------
-------------------------
-------------------------
-------------------------
-------------------------
----------XX--------SSSSS
----------XX-------------
-------XX-XX-------------
-------XX-XX-------------
-------XX-XX-------------
------XXX-XX-------------
------XXX-XX-------------
------XXX-XX-----X-------
XXXXXXXXX-XXXXXXXXXXXX---