-------------------------
-------------------------
-------------------------
-------------------------
-------------------------
-------------------S-----
-------------------------
-------------------------
------------o------------
-----------------------S-
--------------------E----
-------------------<>----
-------------------[]----
---XXXXXXXXXXXXXXXXXXXXXX