-------------------------
-------------------------
-------------------------
-------------------------
-------------------------
S------------------------
-------------------------
-------------------------
-------------------------
S--oooooo--------SS------
------------X------------
------------X------------
------------X----------EE
XXXXXXXXXXXXX--XXXXXXXXXX