-------------------------
-------------------------
-------------------------
-------------------------
-------------------------
-------------------------
-------------------------
-------------------------
-------E-----------------
------<>-----------------
------[]-------------<>--
------[]-------------[]--
------[]-------------[]-E
--XXXXXXXXXXXXXXXXXXXXXXX