-------------------------
-------------------------
-------------------------
-------------------------
-------------------------
-------------------------
-------------------------
-----------------------X-
-o---------------------X-
--------------------XX-X-
-------------E--B---XX-X-
----------------b---XX-X-
---------XX---------XX-X-
---XXX-XXXXXXXXXXXXXXX-X-