-------------------------
-------------------------
-------------------------
-------------------------
-------------------------
-------------------------
-------------------------
------XSS--o-------------
-----XXX-----------------
-----XXX-SS-----------E--
---XXXXX-------------<>--
--XXXXXX--SSS--------[]--
-----XXX-------------[]-E
XXXXXXX------XXXXXXX-XXXX