-------------------------
-------------------------
-------------------------
-------------------------
-------------------------
-------------------------
-------------------------
------------------------o
-------------------------
------------X---------SSS
-----------XX---------E--
----------XXX---E--------
---------XXXX------------
----XXXXXXXXXXX-X-X-XXXXX