-------------------------
-------------------------
-------------------------
-------------------------
-------------------------
-------------------------
-------------------------
------------------XSS--o-
-----------------XXX-----
--------X--------XXX-SS--
-------XX--X---XXXXX-----
------XXX--X--XXXXXX--SSS
-----XXXX--X-----XXX-----
---XXXXXXXXXXXXXXXX------