-------------------------
-------------------------
-------------------------
-------------------------
-------------------------
------SSSSS---SSSSS------
-------------------------
--o----------------------
-------------------------
SS-----------------------
-------------------------
-SSS---------------------
-------------------------
----XXXX----XXXXX---XXXXX