-------------------------
-------------------------
-------------------------
-------------------------
-------------------------
-----------------SSSSSS--
-------------------------
-------------------------
--------------E----------
------QQQ----<>----------
-------------[]----------
------E------[]----------
-------------[]----------
--X-XXXXXXX--XXXXXX-----X