-------------------------
-------------------------
-------------------------
-------------------------
-------------------------
----------SSSSSS---------
-------------------------
-------------------------
-------SSS---------o-----
-------------------------
-----E------------------X
----<>-----------------XX
----[]-------------------
--XXXXXXXXX------X---XXXX