-------------------------
-------------------------
-------------------------
-------------------------
---------------E---------
--------------SQS--------
-------------------------
-------------------------
SQ------------------E----
--------------SQS--<>----
-------------------[]---E
------------X------[]----
SSSSS-------X------[]----
----XX--XXXXXXXXXXXXX--X-