-------------------------
-------------------------
-------------------------
-------------------------
-------------------------
----SS-------------------
-------------------------
----------------------XX-
----------E----------XXX-
---XXXX--<>---------XXXX-
XXXXX----[]--------XXXXX-
XXX------[]-------XXXXXX-
X--------[]------XXXXXXX-
-----XX--XX--XXXXXXXXXX--