-------------------------
-------------------------
-------------------------
-------------------------
-------------------------
---------S---------XX----
-------------------XX----
-----------------X-XX----
--------E-EE-----X-XX----
------------XX-X-X-XX----
------------XX-X-X-XX----
------------XX-X-X-XX----
------------X--X-X-XX----
XXXXXX------X--X-X-XXXXXX