-------------------------
-------------------------
-------------------------
-------------------------
-------------------------
------------------------S
-------------------------
-------------------------
----------XSS-SQ---------
-X-------XXX-----------SS
-X------XXXX-------------
-X-----XXXXX-------------
-X----XXXXXX--SSSSS------
-X--XXXXXXX-------XX---XX