-------------------------
-------------------------
-------------------------
-------------------------
-------------------------
---------S---------------
-------------------------
-------------------------
SQ------E-EE-------------
------------XX-X-------E-
------------XX-X-------E-
------------XX-X---------
SSSSS-------X--X---------
----XX------X--X--XXXXXXX