-------------------------
-------------------------
-------------------------
-------------------------
-------------------------
-------------------------
-------------------------
-------------------------
---------------------E---
----QQ--------------<>---
--------------------[]---
--------X-----------[]---
--------X-----------[]---
--XXXXXXXXXXXXXXXXXXXXXXX