-------------------------
-------------------------
-------------------------
-------------------------
-------------------------
QQQ--QQQQ----------XX----
------------------XXX----
-----------------XXXX----
----------------XXXXX----
SSQQQ?SSQQQ-----XXXXX----
--------------XXXXXXX----
-------------XXXXXXXX----
----------------XXXXX--X-
--XXXX--XXXXXXXXXXXXXXXXX