-------------------------
-------------------------
-------------------------
-------------------------
-------------------------
-------------------------
-------------------------
--------XX-----o---------
--------XX---------------
--------XX--SSS---------E
-------XXX-------------<>
-------XXX-------------[]
-------XXX-------------[]
-XXXXXXXXX--XXXXXXXXXXXXX