-------------------------
-------------------------
-------------------------
-------------------------
-------------E-----------
---------SSSSSS----------
------------------------X
-----------------------XX
----------E-----------XXX
----X----SSSSSS-------XXX
----X---------------XXXXX
----X--------------XXXXXX
----X-----------E-----XXX
----X--XXXXXXXXXXXXXXXXXX