-------------------------
-------------------------
-------------------------
-------------------------
-------------------------
--------------------S----
-------------------------
-------------------------
-------------------E-EE--
-------Q---QQ----------XX
-----------------------XX
-----------------------XX
-----------------------X-
-XXXXXXXXXXXXXXX-------X-