-------------------------
-------------------------
-------------------------
-------------------------
-------------------------
XX----------XX--------XX-
XX---------XXX-------XXX-
XX--------XXXX------XXXX-
XX-------XXXXX-----XXXXX-
XX-------XXXXX-----XXXXX-
XX-----XXXXXXX---XXXXXXX-
XX----XXXXXXXX--XXXXXXXX-
XX-------XXXXX-----XXXXX-
XXXXXXXXXXXXXXXXXXXXXXXXX