-------------------------
-------------------------
-------------------------
-------------------------
-------------------------
---------SSSSSSSS--------
-------------------------
-------------------------
-------------------------
-X-----------------------
-X-----------------------
-X-----------------------
-X-------------------E-EE
-X--XXXXXXX-------XXXXXXX