-------------------------
-------------------------
-------------------------
-------------------------
-------------------------
-----------SS------------
-------------------------
-------------------------
------oo-----------------
-X--------SSS------E-----
-X----------------<>-----
-X----------------[]-----
-X------------E---[]---E-
-X--X-----XXXXXX--XXXXXXX