-------------------------
-------------------------
-------------------------
-------------------------
-------------------------
--SS---------------------
-------------------------
-------------------------
----------------XSS-SQ---
-XXXX----------XXX-------
XXX-----------XXXX-------
X------------XXXXX-------
---------E--XXXXXX--SSSSS
---XX--XXXXXXXXXX-------X