-------------------------
-------------------------
-------------------------
-------------------------
-------------------------
--XX-----------------S---
-XXX---------------------
XXXX---------------------
XXXX----------------E-EE-
XXXX--------------------X
XXXX--------------------X
XXXX--------------------X
XXXX-----EE-E-----------X
XXXXXX--XXXXXXXXXX------X