-------------------------
-------------------------
-------------------------
-------------------------
-------------------------
------------SSSSSSSS---SS
-------------------------
X------------------------
X----oo------------------
X------------------------
X------------------------
X------------------------
X------------------------
X---------XXXX-------XXXX