-------------------------
-------------------------
-------------------------
-------------------------
-------------------------
--S--------------E-------
----------------<>-------
----------------[]-------
-E-EE-----------[]-------
-----XX-X-------XXX------
-----XX-X----------------
-----XX-X----------------
-----X--X-------E--------
-----X--X--XXXXXXXXXXXXX-