-------------------------
-------------------------
-------------------------
-------------------------
-------------------------
--------------XX---------
-------------XXX---------
------------XXXX---------
-----------XXXXX---------
---Q------XXXXXX---------
---------XXXXXXX---------
--------XXXXXXXX---------
-------XXXXXXXXX---EE----
XXXXXXXXXXXXXXXXXXXXXXXXX