-------------------------
-------------------------
-------------------------
-------------------------
-------------------------
---------------------SSSS
-------------------------
-------------------------
S---------------o--------
--------------------SSSSS
---------E---------------
--------<>---------------
--------[]--XX-----------
XXXXXXXXXXXXXXXXXXX-XXXXX