-------------------------
-------------------------
-------------------------
-------------------------
-------------------------
----------------?--------
-------------------------
-------------------------
-------------------------
------<>--Q-----Q--------
------[]----------------E
------[]---------------<>
----E-[]---------------[]
XXXXXXXXXXXXXXXXXXXXXXXXX