-------------------------
-------------------------
-------------------------
-------------------------
-------------------------
QQQ--S----SSSS--------XX-
---------------------XXX-
--------------------XXXX-
-----------E-------XXXXX-
SSQQQQQ--SSSSS-----XXXXX-
-----------------XXXXXXX-
----------------XXXXXXXX-
-------------------XXXXX-
--XXXXXXXXXXXXXXXXXXXXXXX