-------------------------
-------------------------
-------------------------
-------------------------
-------------------------
QQ--S--------------------
-------------------------
-------------------------
-------------oo----------
SQQQQQ------o------------
-------------------------
-------------------------
-----------------X-------
-XXXXXXXXXXXXXXXXXXXX--XX