-------------------------
-------------------------
-------------------------
-------------------------
-------------------------
-------------------------
-------------------------
-------------------------
-------------------------
-------------X--X-----oo-
----X--X----XX--XX-------
----X--X---XXX--XXX------
----X--X--XXXX--XXXX-----
-XXXX--XXXXXXXXXXXXXXXXXX