-------------------------
-------------------------
-------------------------
-------------------------
---------------E---------
-------------SSSSSS--SSSS
-------------------------
-------------------------
-------------------------
---X----------------X----
---XX------E--------X----
---XXX----<>--------X----
---XXXX---[]--------X----
---XXXXXXXXXXXXXXXXXXXX--