-------------------------
-------------------------
-------------------------
-------------------------
-------------------------
--SSSSQSS----------------
-------------------------
-------------------------
---E----------E----------
-SSSSSSSS----<>----------
-------------[]----------
-------------[]----------
----------E-E[]----------
-XXXXXXXXXXXXXXXXXXXX--XX