-------------------------
-------------------------
-------------------------
-------------------------
-------------------------
--SS--------------SS-----
-------------------------
-------------------------
-------------------------
-XXXX---------XX--SSS----
XXX-----------XX---------
X-------------XXX--------
--------------XXX--------
---XX--XXX--XXXXXXXXXXXXX