-------------------------
-------------------------
-------------------------
-------------------------
-------------------------
--------------SS---------
-------------------------
-------------------------
----------o--------------
-------------SSS--------E
-------------------------
-------------------------
-----------------E-E-E---
XXXXXXXXX----XXXXXXXXXXXX