-------------------------
-------------------------
-------------------------
-------------------------
-------------------------
-------------------------
-------------------------
-------------oo----------
-------------------------
---------XXX-------------
---------XXX-------------
---------XXX-------------
---------XXX-----E-E-E---
--XXXXXXXXX---XXXXXXXXXXX