-------------------------
-------------------------
-------------------------
-------------------------
-------------------------
-------------------------
-------------------------
-------------------------
-XSS-SQ------------------
XXX---------SSS----------
XXX----------------------
XXX----------------------
XXX--SSSSS---------------
XX-------XX-XXXXXXXXXXXXX