-------------------------
-------------------------
-------------------------
-------------------------
-------------------------
---SSS---------SSSSSS----
-------------------------
----------X--------------
----------X--------------
-XX----XX-X-------------S
-XX----XX-X--------------
-XXX---XX-X--------------
-XXX---XX-X--------------
-XXXXXXXX-X--XXXX-----XXX