-------------------------
-------------------------
-------------------------
-------------------------
-------------------------
-----------------SSSSSS--
-------------------------
-------------------------
-------------------------
---------X---------------
S--------X---------------
---------X---------------
---------X----X----------
--XXXXX--X--XXXXXXX-----X