-------------------------
-------------------------
-------------------------
-------------------------
-------------------------
QQQ------------------S---
-------------------------
-------------------------
--------------------E-EE-
SSQQQ-----X--SSQS-------X
---------XX-------------X
--------XXX-------------X
-------XXXX-------------X
--XXXXXXXXXXXXXXXX------X