-------------------------
-------------------------
-------------------------
-------------------------
-------------------------
-------------S-----------
-------------------------
-X-----------------------
XX----------E-EE---------
XX--------------XX-XX----
XX--------------XX-XX----
XX--------------XX-XXX---
XX--------------X--XXX---
XXXXXXXXXX------X--XXXXX-