-------------------------
-------------------------
-------------------------
-------------------------
-------------------------
--S----------------XX----
------------------XXX----
-----------------XXXX----
-E-EE-----------XXXXX----
-----XX-X-------XXXXX----
-----XX-X-----XXXXXXX----
-----XX-X----XXXXXXXX----
-----X--X-------XXXXX----
-----X--X--XXXXXXXXXXXXXX