-------------------------
-------------------------
-------------------------
-------------------------
-----------------------E-
----------SSSSSSSS---SSSS
-------------------------
-------------------------
-----o-------------------
-------------------------
-------------------------
-------------------------
-------------------------
XXXX----XXXX-------XXXXXX