---XXXXXXXX--XX
---XXXXXXXX----
&--XXXXXXXX----
---XXXXXXXX--XX
---XXXXXXXX--XX
---XXXXXXXX--XX
---XXXXXXXX--XX
---XX----XX--XX
---------XX--XX
-----XX------XX
---XXXXXXXX--XX