---XXXXXXXXXXXX
---XXXXXXXXXXXX
---XXXXXXXXXXXX
---XXXXXXXXXXXX
---XXXXXXXXXXXX
---XXXXXXXXXXXX
---XXX---------
---------------
------XXXXXXXXX
---XXXXXXXXXXXX
---XXXXXXXXXXXX