XXXXXXXXXXXXXXX
XXXXXXXXXXXXXXX
XXXXXXXXXXXXXXX
XXXXXXXXXXXXXXX
---------------
-----XXXXXXXXXX
-----XXXXXXXXXX
--XXXXXXXXXXXXX
--XXXXXXXXXXXXX
--XXXXXXXXXXXXX
--XXXXXXXXXXXXX