XX------------X
XX-------&----X
XX---XX-------X
XX-#-XXXXXXX--X
XX-----XXXXX---
XXXX---XXXXX---
XXXX---XXXXX--X
XXXX---XXXXX--X
XXXX---XXXXX--X
-------XXXXX--X
&------XXXXX--X