---X--^^^^^^^^^
-^-X--^^^------
---X--^^^--X---
-^-X--^^^--XX--
-----------XXX-
-^----^^^--*#X-
-----------XXX-
-^-X--^^^--XX--
---X--^^^--X---
-^-X--^^^------
---X--^^^^^^^^^