----^^^^^^^^^^^
---------------
---------------
------X--X----X
XX----X--X^---X
#X----XXXX^^--X
XX----X--X^---X
------X--X----X
---------//\\//
---------\\//\\
----^^^^^^^^^^^