^^^^^^^^^^^-^-^
------------^-^
--------------^
---------------
--------&------
---------------
--------^------
--------^------
--------^-----^
-----X--^---^-^
^^^^^^^^^^^-^-^