^^^^^^^^^^^^^^^
&--------------
^^-------------
^^---X--X----XX
^^---X--X^---X*
^^---XXXX^^--X&
^^---X--X^---X*
^^---X--X----XX
^^------//\\//\
&-------\\//\\/
^^^^^^^^^^^^^^^