-^^^^^^^^^^^^^^
--------------&
-------------^^
----X-----X--^^
----X-&-&-X--^^
----XXXXXXX--^^
----X-*#*-X--^^
----X-----X--^^
-------------^^
--------------&
-^^^^^^^^^^^^^^