^^^^^^^^^^^^^^^
X------------X-
X--X------X--X-
X--XX----XX--X-
X--XXX--XXX----
X--*#X--X#*----
X--XXX--XXX----
X--XX----XX----
X--X------X----
---------------
^^^^^^^^^^^^^^^