^^^^^^^^^^^^^^^
---------------
----------X--X-
---XXX---XX--X-
---X*X--XXX--X-
^--X&---X#*--X-
---X*X--XXX--X-
---XXX---XX--XX
\\//\\----X--XX
//\\//-------*#
^^^^^^^^^^^^^^^