XX------------^
--------------^
--------#-----^
---------------
---------------
----&---------^
--------------^
--------------^
-----------&--^
--------------^
XX------------^