XX--XXX--------
XX--XXX--------
XX--XXX---XX---
XX--XXX-#-XXXXX
XX--XXX-----XXX
XXXXXXXXX---XXX
XXXXXXXXX---XXX
XXXXXXXXX--#XXX
XXXXXXXXX---XXX
------------XXX
&----&------XXX