XXXXXXXXX--XXXX
XXXXXXXXX----XX
XXXXXXXXX------
XXXXXXXXX--XX--
-#XXXXX----XXXX
--XXXX-----XXXX
---*-------XXXX
XXXXXXXXX--XXXX
XXXXXXXXX--XXXX
XXXXXXXXX--XXXX
XXXXXXXXX--XXXX