-------X-------
--X----X-------
*-X----X-------
XXX----X-------
-------X-----XX
---#---X-&---&-
-------X-----XX
XXX----X-------
*-X----X-------
--X----X-------
---------------