--------XXXXXXX
---------XXXXXX
----------XXXXX
#--X-------XXX-
*--X-----------
XXXX--------&--
*--X-----------
#--X-------XXX-
----------XXXXX
---------XXXXXX
--------XXXXXXX