XXX--XXX-------
XXX--XXX-------
XXX--XXX---XX--
XXX--XXX-#-XXXX
XXX--XXX-----XX
XXXXXXXXXX---XX
XXXXXXXXXX---XX
XXXXXXXXXX---XX
XXXXXX*XXX---XX
-------------XX
-&----#------XX