--XXXXXXXXXXXXX
--XXXXXXXXXXXXX
--XXXXXXXXXXXXX
--XXXXXXXXXXXXX
-XX------------
XXX---------#--
XXX-----#-----*
XXX---XXXXXXXXX
------XXXXXXXXX
------XXXXXXXXX
------XXXXXXXXX