&-*-XX---------
----XX---*-//\\
----XX-----\\//
#---XX---------
----XX---------
----XX---------
----XX---------
#-XXXX---------
--XX-------//\\
-----------\\//
---------------