XXXXXX---XXXXX-
^^^------XXXX--
^^^------XXX---
^^^------XX----
---------------
^^^------------
---------------
^^^------XX----
^^^------XXX---
^^^------XXXX--
XXXXXX---XXXXX-