---XXXXXXXXXXXX
---XXXXXXXXXXXX
---XXXXXXXXXXXX
---XXXXXXXXXXXX
--XX--------*--
-XXX-----------
-XXX---------#-
XXXX------XXXXX
-------#--XXXXX
----------XXXXX
----------XXXXX