XXXXXXXXXXXXXXX
XXXXXXXXXXXXXXX
XX--XX*&XXXX*#X
XX--XX--XXXX--X
XX--XX--XXXX--X
---------------
XX--XX--XXXX--X
XX--XX--XXXX--X
XX*&XX--XXXX--X
XXXXXXXXXXXXXXX
XXXXXXXXXXXXXXX