XX-------------
XX----------//\
&-----------\\/
---------------
XX------------#
XX-------------
XX-------------
XX----X*X---*--
XX----X-X------
XX----X#X------
XX----XXX------