------------^^^
------------^^^
-------------*-
------------^^^
------------^^^
------------^^^
------------^^^
#----&------^^^
-------------&-
------------^^^
------------^^^