XXXXXXXXXXXXXXX
XXXXXXXXXXXXXXX
-XX*&XX--XX--XX
-XX--XX--XX--XX
-XX--XX--XX--XX
---------------
-XX--XX--XX--XX
-XX--XX--XX--XX
#XX--XX*&XX*#XX
XXXXXXXXXXXXXXX
XXXXXXXXXXXXXXX