&------*XXXXXXX
^^------XXXXXXX
^^------XXXXXXX
^^------XX-&-XX
^^-------------
^^-----#-------
^^-------------
^^------XXXXXXX
^^------XXXXXXX
^^------XXXXXXX
*-------XXXXXXX