XXXXXXXXXXXXXXX
---------------
---X-----------
---XX---X-----X
---XXX--X-----X
--&*#X--XXXXXXX
---XXX--X-*#*-X
---XX---X--&--X
---X-----------
---------------
XXXXXXXXXXXXXXX