XXXXXXXXX^^^^^-
XXXXXXXXX^^^^^-
XXXXXXXXX^^^^^-
XXXXXXXXX^^^^^-
XXXXXXXXX^^^^^-
--XXXXXXX^^^^^-
-------XX------
XX-------------
XXXXXXX--^^^^^-
XXXXXXXXX^^^^^-
XXXXXXXXX^^^^^-