XXXXXXXXXXXXXXX
XXXXXXXXX--^^^^
XXXXXXXXX--^^^^
XXXXXXXXX--^^^^
-----------^^^-
------------&--
-----------^^^-
-------XX--^^^^
#--#---XX--^^^^
-------XX--^^^^
-------XXXXXXXX