XXXXXXXXXXXXXXX
X*#XX*#XXXXXXXX
X--XX--XXXXXXXX
X--XX--XXXXXXXX
---------*-----
-----------#--#
---------------
X--XX--XXXXXXXX
X--XX--XXXXXXXX
X--XX--XXXXXXXX
XXXXXXXXXXXXXXX