-XXXXX^^^^---^-
-XXXXX^^^^---^-
-XXXXX^^^^---^-
-XXXXX^^^^---^^
-XXXXX---------
XXXX-----------
------^^^^-----
----XX^^^^-----
XXXXXX^^^^----#
XXXXXX^^^^-----
XXXXXX^^^^-----