---XX^^^^XXXXX^
#--XX^^^^XXXXX^
---XX^^^^XXXXX^
---XX^^^^XXXXX^
*--XX^^^^XXXXX^
XXXXX^^^^XXXXX^
-----^^^^XXXXX^
-------^^---XX-
-XXXX----------
-XXXX^^--XXX--^
-XXXX^^^^XXXXX^