---XXXX^^^^^XXX
#--XXXX^^^^^XXX
---XXXX^^^^^XXX
---XXXX^^^^^XXX
*--XXXX^^^^^XXX
XXXXXXX^^^^^XXX
-------^^^^^XXX
------------XX-
-XXXXXX--------
-XXXXXX^^^^^--X
-XXXXXX^^^^^XXX