---X--X----^^^^
---X-------^^^^
^--X--X----^^^^
^--X--X----^^^^
^-----X--------
^-----X--------
-#-#--X----^^^^
------XX---^^^^
------XXX--^^^^
XXXX--&#X--^^^^
XXXX--XXX--^^^^