XXXXXXXXXXXXXXX
^^^^^^^^--XXXXX
^^^------------
----------XX---
---------------
----------XX---
---------------
----------XX---
^^^------------
^^^^^^^^--XXXXX
XXXXXXXXXXXXXXX