-----&----^^^^^
----^^^---^^^^^
*---^^^---^^^^^
----^^^---^^^^^
----^^^---^^^^^
----^^^---^^^^^
----^^^---^^^^^
----^^^---^^^^^
*---^^^--------
----^^^--------
-----*----^^^^^