*-------^------
^^------^---X--
^^--&---^---X-*
^^------^^^^XXX
^^----------^--
^^----------^--
^^----------^--
^^----------XXX
^^-------#--X-*
^^----------X--
&--------------