XXXXX^^^^^^^^^^
XXXXX^^^^^^^^^-
X----^^^^^^^---
--------------^
-XXXX-------^^^
XXXXX^^^^^^^^^^
XXXXX^^^^^^^^^^
XXXXX^^^^^^^^^^
XXXXX^^^^^^^^^^
XXXXX^^^^^^^^^^
XXXXX^^^^^^^^^^