---XX^^^^^^^XXX
#--XX^^^^^^^XXX
---XX^^^^^^^XXX
---XX^^^^^^^XXX
*--XX^^^^^^^XXX
XXXXX-----^^---
---------------
-----^^^^^--XXX
-XXXX^^^^^^^XXX
-XXXX^^^^^^^XXX
-XXXX^^^^^^^XXX