XXXXXXXXXXXXXXX
---*-----XXXXXX
---------XXXXXX
--^^^----XXXXXX
^^^^^^^----*---
---&-----------
^^^^^^^-----#--
--^^^----XXXXXX
---------XXXXXX
---*-----XXXXXX
XXXXXXXXXXXXXXX