^^^^^^^^^^--XXX
---^---^----XX-
---^---^----XX-
-------^----XX-
---------------
---------------
---------------
------------XX-
------------XX-
------------XX*
^^^^^^^^^^--XXX