XXXXXXXXXXXXXXX
-----^^^^^^^^^^
-------^^^-----
---------------
---------------
---------------
---------------
X--------------
XX-----^^^-----
#X---^^^^^^^^^^
XXXXXXXXXXXXXXX