#D------------##
##TTT####-----##
##------------##
----------------
---------####---
MMMMMMMM#MMMMMMM
----------------
----H--------H--
MMMMMMMMMMMMMMMM
----------------
---H-----H------
MMMMMMMMMMMMMMM#
----------------
---H---H--------
MMMMMMMMMMMMMMMM
##--------TTTTTT
#d-------------#
#D-------------#
#####---########
################
####---#####-###
#------------###
#-------------d#
#-------------D#
#-d---------####