#D----------####
########H---####
####------######
----------------
--H--------H----
MMMMMMMMMMMMMMMM
--------------#-
----------------
MMMMMMMMMMMMMMMM
----------------
##----------####
##-----------###
-#######H--####-
-####------####-
-####----H#####-
#d----------####
#D----------####
########H---####
####------######
----------------
------TTTT------
----------------
-------####-----
----#HHH--------
########-------#