####H-H#######--
####------####--
####H-H#######--
####------####--
##-----------###
-#######H--####-
----------------
####--------TTTT
----------------
---TTTT---------
----------------
----TTTT--------
-#######H--####-
-----------#----
-####----H#####-
#d----------####
#D----------####
########H---####
####------######
####------####--
####H-H#######--
####------####--
####H-H#######--
####------####--
####H-H#######--