----------------
--H--------H----
MMMMMMMMMMMMMMMM
----------------
--H--------H----
MMMMMMMMMMMMMMMM
--------------#-
------------TTTT
--------------#-
----------------
---------#------
-----H---#---H--
MMMMMMMMM#MMMMMM
----------------
--H--------H----
MMMMMMMMMMMMMMMM
----------------
----------------
####--------####
--H--------H----
MMMMMMMMMMMMMMMM
----------------
--------------T-
----------------
##----------####