---H-----H------
MMMMMMMMMMMMMMM#
----------------
----------------
----------------
------T---TT----
----------------
----------------
----------------
#MMMMMMMMMMMMMMM
----------------
---H-----H------
MMMMMMMMMMMMMMM#
----------------
---H-----H------
MMMMMMMMMMMMMMM#
----------------
-----TTTT-------
----------------
---H-----H------
MMMMMMMMMMMMMMM#
----------------
-------####-----
----#HHH--------
########-------#