---#HHH---------
---d###---------
---D------------
####---------###
----------------
--H--------H----
MMMMMMMMMMMMMMMM
----H--------H--
----------------
---TTTT---------
----------------
----TTTT--------
----------TTT---
---------d------
---------D------
--------TTTT----
----------------
MMMMMMMMMMMMMMMM
----------------
---H-----H------
MMMMMMMMMMMMMMM#
----------------
----------------
#MMMMMMMMMMMMMM#
#--------------#