###-#----#--#--M----M--#-
###-M----M--M--M----M--M-
###-M----M--M--M----M--M-
#T#-M----M--M--M----#--M-
-T--M----M--M--M----M--M-
-T--M----M--M--M----M--M-
-T--MH-#-MH-MH-M----M--MH
----M--#-M--M--M-T--M--M-
----M--#-M--M--M-T--M--M-
----M--#-M--M--M----M--M-
----M----M--M--M----M--M-
----M----M--M--M----M--M-
###-MH---MH-MH-M----M--MH
###-M----M--M--M----M--M-
###-M----M--M--M----M--M-
###-M----M--M--#----M--M-