---H-----H------
MMMMMMMMMMMMMMM#
----------------
----------------
MMMMMMMMMMMM#MMM
----------------
----------------
-------TT-------
----------------
#MMMMMMMMMMMMMMM
----------------
---H-----H------
MMMMMMMMMMMMMMM#
----------------
---H-----H------
MMMMMMMMMMMMMMM#
----------------
------####------
----------------
---H-----H------
MMMMMMMMMMMMMMM#
----------------
####--------####
####-----TTTT###
####--------####