#---##-M-#--#--M-M-----#-
######-M-M--M--M-M-----M-
######-M-M--M--M-M-----M-
####-#-M-M--M--M-M-----M-
-###---M-M--M--M-M---T-M-
-#-----M-M--M--M-M-T-T-M-
-H-----M-MH-MH-M-M-T-T-MH
---H---M-M--M--M-M---T-M-
---#---M-M--M--M-M-----M-
---#---M-M--M--M-M-T---M-
---#---M-M--M--M-M-T---M-
-###---M-M--M--M-M-----M-
-###---M-MH-MH-M-M-----MH
-###---M-M--M--M-M-----M-
######-M-M--M--M-M-----M-
#---##-M-M--M--#-M-----M-