#--------##-#--M-#-M--M--
----#-#####-M--M-#-M--M--
----#-#####-M--M-#-M--M-#
----#-###-#-M--M-#-M--M-#
----#-###---M--M-#-MH-M-T
--#H--#-----M--M-#-M--M-T
--#H--H-----MH-M-#-M--M-T
--#H----H---M--M---M--M--
#H##----#---M--M---M--MH-
#H------#---M--M---M--M--
#H------#---M--M---M--M--
##----###---M--M---M--M--
#-----###---MH-M---M--M--
#-----###---M--M---MH-M--
#-----#####-M--M---M--M--
#--------##-M--#---M--M--