---H-----H------
MMMMMMMMMMMMMMM#
----------------
----------------
----------------
-----TT--TT-----
----------------
MMMMMMMMMMMMMMMM
----------------
#MMMMMMMMMMMMMMM
----------------
---H-----H------
MMMMMMMMMMMMMMM#
----------------
---H-----H------
MMMMMMMMMMMMMMM#
----------------
------####------
----------------
---H-----H------
MMMMMMMMMMMMMMM#
----------------
-------####-----
----#HHH--------
########-------#