--####---#-----##---#----
--#######M--#########----
#########M--#############
#########M--###-####-####
###---###M--###--###-####
###---#--M--#----#---####
#-----H--MH-H----H----#-#
#--H----HM----H----H--#-#
#--#----#M----#----#--#-#
H--#----#M----#----#--H-H
---#----#M----#----#-----
H--#--###M--###--###--H-H
####--###MH-###--###-####
####--###M--###--###-####
####Dd###M--#############
######---M-----##---#####