----------------
----H--------H--
MMMMMMMMMMMMMMMM
----------------
--H--------H----
MMMMMMMMMMMMMMMM
----------------
MMMMMMMMMMMMMMMM
----------------
#MMMMMMMMMMMMMMM
----------------
---H-----H------
MMMMMMMMMMMMMMM#
----------------
---H-----H------
MMMMMMMMMMMMMMM#
----------------
MMMMMMMMMMMMMMMM
----------------
##----------####
##-----------###
-#######H--####-
-####------####-
-####----H#####-
##----------####