----------------
----H--------H--
MMMMMMMMMMMMMMMM
#------#-------#
--H--------H----
MMMMMMMMMMMMMMMM
MMMMMMMMMMMMMMMM
----H--------H--
MMMMMMMMMMMMMMMM
----------------
---H-----H------
MMMMMMMMMMMMMMM#
----------------
####------------
-####----H#####-
#d----------####
#D----------####
########H---####
####------######
####------####--
####H-H#######--
####------####--
----------------
MMMMMMMMMMMM#MMM
----------------