--####---##-#--M-#-M--M--
--#########-M--M-M-M--M--
###########-M--M-M-M--M--
#########-#-M--M-M-M--M--
###---###---M--M-M-MH-MH-
###---#-----M--M-M-M--M--
#-----H-----MH-M-MHM--M--
#--H----H---M--M-M-M--M--
#--#----#---M--M-M-M--M--
H--#----#---M--M-M-M--M--
---#----#---M--M-M-M--M--
H--#--###---M--M-M-M--M--
####--###---MH-M-MHM--M--
####--###---M--M-M-MH-MH-
####Dd#####-M--M-M-M--M--
######---##-M--#-M-M--M--