#--------#--#--M-M-M--M--
----#-###M--M--M-M-M--M--
----#-###M--M--M-M-M--M--
----#-###M--M--M-M-M--M--
----#-###M--M--M-M-MH-MH-
--#H--#--M--M--M-M-M--M--
--#H--H--MH-MH-M-M-M--M--
--#H----HM--M--M-M-M--M--
#H##----#M--M--M-M-M--M--
#H------#M--M--M-M-M--M--
#H------#M--M--M-M-M--M--
##----###M--M--M-M-M--M--
#-----###MH-MH-M-M-M--M--
#-----###M--M--M-M-MH-MH-
#-----###M--M--M-M-M--M--
#--------M--M--#-M-M--M--