#D----------####
########H---####
####------######
----------------
--H--------H----
MMMMMMMMMMMMMMMM
----------------
----H--------H--
MMMMMMMMMMMMMMMM
----------------
---H-----H------
MMMMMMMMMMMMMMM#
----------------
---H---H--------
MMMMMMMMMMMMMMMM
----------------
-####------####-
-####------####-
-####----H#####-
#d----------####
#D----------####
########H---####
####------######
####------####--
####H-H#######--