####H-H#######--
####------####--
####H-H#######--
#H-----------H##
#MMMMMMMMMMMMMM#
MMMMMMMM#MMMMMMM
----------------
----H--------H--
MMMMMMMMMMMMMMMM
#MMMMMMMMMMMMM##
#--------------#
#H-----------H##
#MMMMMMMMMMMMMM#
-####----H#####-
#MMMMMMMMMMMMM##
#d----------####
####------######
####------####--
####H-H#######--
####------####--
####H-H#######--
####------####--
##-----------###
----------------
--TTTT-----TTTT-