##--#--M-----#-#M--M--M--
-M--M--M-----M-#M--M--M--
-M--M--M-----M-MMH-M--M--
-M--M--M----TM-MM--M--M--
-M--M--M-T--TM-MM--MH-MH-
-M--M--M-T--TM-MM--M--M--
-M--MH-M-TDd-MHMM--M--M--
-M--M--M-T---M-MM--M--M--
-M--M--M-----M-MM--M--M--
-M--M--M-----M-MM--M--M--
-M--M--M-----M-MM--M--M--
-M--M--M-----M-MMH-M--M--
-M--MH-M-----MHMM--M--M--
-M--M--M-----M-MM--MH-MH-
-M--M--M-----M-MM--M--M--
##--M--M-----M-#M--M--M--