------#####-####M--M#-###
------######M#-#M--M#-###
#-########M#MH-MMH-M#-###
#-########M#M--MM--M#-###
#T#####---M#M--MM--M-T#--
#T#####---M#M--MM--M-T#--
-T#-#-----MHM--MM--M-T---
--#-#--H--M-M--MM--#-T-H-
--#-#--#--M-M--MM--M---#-
##H-H--#--M-M--MM--M---#-
##-----#--M-M--MM--M---#-
##H-H--#--M#M--MMH-M---#-
Dd######--M#M--MM--M#-##-
--######--M#M--MM--M#-##-
--######DdM#MH-MM--M#-##D
--#########-####M--M#-###