#MMMMMMMMMMMMMM#
#--------------#
#--------------#
#H-----------H##
#MMMMMMMMMMMMMM#
----------------
----------------
#-D-----####----
MMMMMMMMMMMMMMMM
----------------
---H-----H------
MMMMMMMMMMMMMMM#
MMM#MMMMMMMMMMMM
----------------
---H-----H------
MMMMMMMMMMMMMMM#
----------------
MMMMMMMMMMMMMMMM
----------------
---H-----H------
MMMMMMMMMMMMMMM#
MMMMMMMMM#MMMMMM
----------------
---#------------
-H-#---H--------