-M-M#--M-#---#--M-M---M--
-M-MM--M-M---M--M-M---M--
-M-MM--M-M---M--MHM---M--
-#-MM--M-M---M--M-M---M--
-M-MM--M-M---M--M-MHH-MH-
-M-MM--M-M---M--M-M---M--
-M-MMH-M-MH--MH-M-M---M--
-M-MM--M-M---M--M-M---M--
-M-MM--M-M---M--M-M---M--
-M-MM--M-M---M--M-M---M--
-M-MM--M-M---M--M-M---M--
-M-MM--M-M---M--MHM---M--
-M-MMH-M-MH--MH-M-M---M--
-M-MM--M-M---M--M-MHH-MH-
-M-MM--M-M---M--M-M---M--
-M-MM--M-M---M--M-M---M--