##-M--####---#--M--------
#M-M--#######M--M--#-----
-M-M#########M--MH-######
-M-M#########M--M--######
-M-M###---###M--M--######
-M-M###---#--M--M---#####
-M-M#-----H--MH-M---#-#-#
-M-M#--H----HM--M--H#-#-#
dM-M#--#----#M--M--##-#-#
#M-MH--#----#M--M--#H-H-H
#M-M---#----#M--M--#-----
HM-MH--#--###M--MH-#H-H-H
-M-M####--###MH-M--######
-M-M####--###M--M--######
-M-M####Dd###M--M--######
##-M######---M--M---#####