####H-H#######--
####------####--
####H-H#######--
#H-----------H##
#MMMMMMMMMMMMMM#
-#######H--####-
-####------####-
-####----H#####-
#d----------####
#D----------####
########H---####
#H-----------H##
#MMMMMMMMMMMMMM#
----------------
-####----H#####-
#d----------####
#D----------####
########H---####
####------######
####------####--
####H-H#######--
####------####--
####H-H#######--
####------####--
####H-H#######--