-####----H#####-
#d----------####
#D----------####
########H---####
####------######
-#######H--####-
-####------####-
-####----H#####-
#d----------####
#D----------####
########H---####
####------######
----------------
####MMMMMMMMMM##
#D----------####
########H---####
#D----------####
########H---####
####------######
####------####--
####H-H#######--
####------####--
####H-H#######--
#---H##d------##
#----##D------##