####H-H#######--
####------####--
####H-H#######--
#H-----------H##
#MMMMMMMMMMMMMM#
MMMMMMMM#MMMMMMM
----------------
----H--------H--
MMMMMMMMMMMMMMMM
#MMMMMMMMMMMMM##
#--------------#
#H-----------H##
#MMMMMMMMMMMMMM#
----------------
---H-----H------
MMMMMMMMMMMMMMM#
----------------
#D-------------#
----------------
---H-----H------
MMMMMMMMMMMMMMM#
#H-----------H##
----------------
#MMMMMMMMMMMMMM#
########-------#