######---#--#--M-M-M--###
#########M--M--M-M-M--M##
--#######M--M--M-M-M--M##
--#######M--M--M-M-M--M##
--#---###M--M--M-M-MH-M--
--#---#--M--M--M-M-M--M--
------H--MH-MH-M-M-M--M--
---H----HM--M--M-M-M--MH-
Dd-#----#M--M--M-M-M--M#-
##-#----#M--M--M-M-M--M#-
##-#----#M--M--M-M-M--M#-
-H-#--###M--M--M-M-M--M#-
--##--###MH-MH-M-M-M--M#-
--##--###M--M--M-M-MH-M#-
--##Dd###M--M--M-M-M--M#D
######---M--M--#-M-M--###