#--------------#
#H-----------H##
#MMMMMMMMMMMMMM#
#H-----------H##
#MMMMMMMMMMMMMM#
MMMMMMMM#MMMMMMM
----------------
----H--------H--
MMMMMMMMMMMMMMMM
#MMMMMMMMMMMMM##
#--------------#
#H-----------H##
#MMMMMMMMMMMMMM#
-####----H#####-
-####----H#####-
#d----------####
#D----------####
MMMMMMMMMMMMMMMM
----------------
---H-----H------
MMMMMMMMMMMMMMM#
----------------
----------------
#MMMMMMMMMMMMMM#
##----------####