####H-H#######--
####------####--
####H-H#######--
####------####--
####H-H#######--
-#######H--####-
MMMMMMMMMMMMMMMM
----H--------H--
MMMMMMMMMMMMMMMM
#MMMMMMMMMMMMM##
#--------------#
#H-----------H##
#MMMMMMMMMMMMMM#
-####----H#####-
#MMMMMMMMMMMMM##
#d----------####
#D----------####
########H---####
#####---########
####------####--
####H-H#######--
####------####--
####H-H#######--
####------####--
####H-H#######--