----------------
--H--------H----
MMMMMMMMMMMMMMMM
----------------
--H--------H----
--H--------H----
MMMMMMMMMMMMMMMM
----H--------H--
MMMMMMMMMMMMMMMM
----------------
---H-----H------
MMMMMMMMMMMMMMM#
MMM#MMMMMMMMMMMM
----------------
---H-----H------
MMMMMMMMMMMMMMM#
----------------
MMMMMMMMMMMMMMMM
----------------
---H-----H------
MMMMMMMMMMMMMMM#
####------####--
####H-H#######--
-------H--------
----------------