------##-##-##--M-M-##---
------##-M##MM--M-M#M#---
########-MM#MM--MHM#MH###
########-MM#MM--M-M#M-###
#######--MM#MM--M-M#M-###
#######--MM#MM--M-M-M-###
#-#-#----MMHMMH-M-M-M-#-#
#-#-#--H-MM-MM--M-MHM-#-#
#-#-#--#-MM-MM--M-M#M-#-#
H-H-H--#-MM-MM--M-M#M-H-H
-------#-MM-MM--M-M#M----
H-H-H--#-MM#MM--MHM#M-H-H
########-MM#MMH-M-M#M-###
########-MM#MM--M-M#M-###
########-MM#MM--M-M#MH###
########-M#-#M--M-M-#####