#--M#--M##--##--M-MM--M--
#--MM--M####MM--M-MM--M--
---MM--M####MM--MHMM--M--
---MM--M####MM--M-MM--M--
---MM--M--##MM--M-MMH-MH-
---MM--M--##MM--M-MM--M--
---#MH-M--HHMMH-M-MM--M--
---MM--M----MM--M-MM--M--
d--MM--M----MM--M-MM--M--
#--MM--M----MM--M-MM--M--
#--MM--M----MM--M-MM--M--
H--MM--M--##MM--MHMM--M--
-#-MMH-M--##MMH-M-MM--M--
---MM--M--##MM--M-MMH-MH-
---MM--MDd##MM--M-MM--M--
#--MM--M##--#M--M-MM--M--