####-----####---
####-----####---
####--------####
####--------####
####--------####
##------------##
#-----TTTT-----#
---------TTTT---
----------------
-#--------------
##----------####
##----------####
##----------####
########H---####
####------######
####------####--
----------------
####----------##
########------##
############--##
##------------##
##----##########
##------------##
####--------####
####--------####