#-----########-#
#-----##-------#
####-----------#
############---#
###########----#
####----------##
####------######
####------####--
####H-H#######--
####------####--
##-----------###
##-----------###
##-----------###
##########---###
####-----------#
####-----------#
####-----------#
---------####--#
##-------##---##
##----#####---#-
##------------#-
#####---------#-
--------------##
---####-------##
-----##-------##