----------------
--H--------H----
MMMMMMMMMMMMMMMM
----------------
#MMMMMMMMMMMMMM#
--H--------H----
MMMMMMMMMMMMMMMM
----H--------H--
MMMMMMMMMMMMMMMM
----------------
---H-----H------
MMMMMMMMMMMMMMM#
MMM#MMMMMMMMMMMM
----------------
---H-----H------
MMMMMMMMMMMMMMM#
----------------
MMMMMMMMMMMMMMMM
----------------
---H-----H------
MMMMMMMMMMMMMMM#
#H-----------H##
#MMMMMMMMMMMMMM#
#MMMMMMMMMMMMMM#
-H-#---H--------