######-###M--#--M--M--###
##M#######M--M--M--M--###
--M#######M--M--MH-M--###
--M#######M--M--M--M--###
--M---#---M--M--M--MH-#--
--M---#---M--M--M--M--#--
--M---H---M--MH-M--M-----
--MH---H-HM--M--M--M---H-
DdM#---#-#MH-M--M--M---#-
##M#---#-#M--M--M--M---#-
##M#---#-#M--M--M--M---#-
-HM#--##-#M--M--MH-M---#-
--M#--##-#MH-MH-M--M--##-
--M#--##-#M--M--M--MH-##-
--M#Dd##D#M--M--M--M--##D
######-###M--M--M--M--###