---H-----H------
MMMMMMMMMMMMMMM#
#MMMMMMMMMMMMMM#
----------------
--H--------H----
MMMMMMMMMMMMMMMM
----------------
----H--------H--
MMMMMMMMMMMMMMMM
----------------
---H-----H------
MMMMMMMMMMMMMMM#
----------------
---H---H--------
---H-----H------
MMMMMMMMMMMMMMM#
----------------
MMMMMMMMMMMMMMMM
----------------
---H-----H------
MMMMMMMMMMMMMMM#
#H-----------H##
#MMMMMMMMMMMMMM#
#MMMMMMMMMMMMMM#
#---H##d------##