#D----------####
########H---####
####H-H#######--
#H-----------H##
#MMMMMMMMMMMMMM#
-#######H--####-
-####------####-
-####----H#####-
#d----------####
#D----------####
########H---####
#H-----------H##
#MMMMMMMMMMMMMM#
----------------
---H-----H------
MMMMMMMMMMMMMMM#
#D----------####
########H---####
-####----H#####-
#d----------####
#D----------####
########H---####
####H-H#######--
####------####--
####H-H#######--