#--------------#
#H-----------H##
#MMMMMMMMMMMMMM#
#H-----------H##
#MMMMMMMMMMMMMM#
--H--------H----
MMMMMMMMMMMMMMMM
----H--------H--
MMMMMMMMMMMMMMMM
#MMMMMMMMMMMMM##
#--------------#
#H-----------H##
#MMMMMMMMMMMMMM#
-####----H#####-
---H-----H------
MMMMMMMMMMMMMMM#
#D----------####
MMMMMMMMMMMMMMMM
----------------
---H-----H------
MMMMMMMMMMMMMMM#
----------------
####H-H#######--
#---H##d------##
##H----####----#