####H-H#######--
####------####--
####H-H#######--
####------####--
####H-H#######--
-#######H--####-
-####------####-
-####----H#####-
MMMMMMMMMMMMMMMM
#D----------####
########H---####
#H-----------H##
-####----H#####-
-####----H#####-
#D----------####
########H---####
#D----------####
########H---####
####------######
---H-----H------
####H-H#######--
#H-----------H##
####H-H#######--
#---H##d------##
#----##D------##