##-#--###-#-##-#M-MM--M--
#M-#--###-##MM-#M-MM--M--
-M#H#-######MM-MMHMM--M--
-M#-#-######MM-MM-MM--M--
-M#-#-#--#-#MM-MM-MMH-MH-
-M#-#-#--#-#MM-MM-MM--M--
-M#-#H-----HMMHMM-MM--M--
-M#-#--H----MM-MM-MM--M--
dM#-#--#----MM-MM-MM--M--
#MH-H--#-#--MM-MM-MM--M--
#M-----#-#--MM-MM-MM--M--
HMH-H--#-#-#MM-MMHMM--M--
-M#-#H##-D-#MMHMM-MM--M--
-M#-#-##---#MM-MM-MMH-MH-
-M#H#-##D-D#MM-MM-MM--M--
#####-###-#-#M-#M-MM--M--