#--------------#
#H-----------H##
#MMMMMMMMMMMMMM#
#H-----------H##
#MMMMMMMMMMMMMM#
--H--------H----
MMMMMMMMMMMMMMMM
----H--------H--
MMMMMMMMMMMMMMMM
#MMMMMMMMMMMMM##
---H-----H------
MMMMMMMMMMMMMMM#
#MMMMMMMMMMMMMM#
----------------
---H-----H------
MMMMMMMMMMMMMMM#
#D----------####
########H---####
####------######
---H-----H------
####H-H#######--
#H-----------H##
#MMMMMMMMMMMMMM#
#MMMMMMMMMMMMMM#
#---H##d------##