######-###--####M--M-###-
##M######M-#M###M--M-####
--M######M-#MH##MH-M-####
--M######M-#M-##M--M-####
--M---#--M-#M---M--MH---#
--M---#--M-#M---M--M----#
--M---H--MHHM---M--M----H
--MH---H-M--M-H-M--M-H---
DdM#---#-M--M-#-M--M-#---
##M#---#-M--M-#-M--M-#---
##M#---#-M--M-#-M--M-#---
-HM#--##-M-#M-#-MH-M-#--#
--M#--##-MH#M-#-M--M-#--#
--M#--##-M-#M-#-M--MH#--#
--M#Dd##DM-#MH#DM--M-#Dd#
######-##M--####M--M-###-