####H-H#######--
####------####--
####H-H#######--
#H-----------H##
####H-H#######--
-#######H--####-
MMMMMMMMMMMMMMMM
----H--------H--
MMMMMMMMMMMMMMMM
#D----------####
########H---####
MMMMMMMMMMMMMMM#
#MMMMMMMMMMMMMM#
-####----H#####-
#D----------####
########H---####
#D----------####
########H---####
####------######
####------####--
####H-H#######--
#---H##d------##
#----##D------##
#---H##d------##
#----##D------##