-###--#####-#####----#-##
-#M#--######M#######-#-##
#-MH#-######MH###########
#-M-#-######M-###########
#-M-#-#----#M----####-#--
#-M-#-#----#M----#--#-#--
#-M-#H-----HM----H--#-#--
#-M-#--H-H--M-H----H#H#H-
#dM-#--#-#--M-#----#####-
H#M-H--#-#--M-#----#H#H#-
-#M----#-#--M-#----#-#-#-
HHM-H--#-#-#M-#--###H#H#-
#-M-#H##-#-#M-#--#######-
#-M-#-##-#-#M-#--#######-
#-MH#-##D#D#MH#Dd#######D
#####-#####-#####---#####