---H-----H------
MMMMMMMMMMMMMMM#
#D----------####
########H---####
####H-H#######--
-#######H--####-
-####------####-
-####----H#####-
#d----------####
#D----------####
########H---####
#H-----------H##
#MMMMMMMMMMMMMM#
-####----H#####-
---H-----H------
MMMMMMMMMMMMMMM#
#D----------####
########H---####
-####----H#####-
#d----------####
#D----------####
########H---####
#MMMMMMMMMMMMMM#
#---H##d------##
#----##D------##