#D----------####
########H---####
#MMMMMMMMMMMMMM#
#H-----------H##
#MMMMMMMMMMMMMM#
--H--------H----
MMMMMMMMMMMMMMMM
----H--------H--
MMMMMMMMMMMMMMMM
#MMMMMMMMMMMMM##
---H-----H------
MMMMMMMMMMMMMMM#
#MMMMMMMMMMMMMM#
-####----H#####-
#D----------####
MMMMMMMMMMMMMMM#
----------------
MMMMMMMMMMMMMMMM
----------------
---H-----H------
MMMMMMMMMMMMMMM#
#---H##d------##
####H-H#######--
#MMMMMMMMMMMMMM#
---D###---####--