#D----------####
########H---####
####H-H#######--
#H-----------H##
#MMMMMMMMMMMMMM#
--H--------H----
MMMMMMMMMMMMMMMM
-####----H#####-
#d----------####
#D----------####
########H---####
#H-----------H##
#MMMMMMMMMMMMMM#
-####----H#####-
#D----------####
########H---####
#D----------####
########H---####
-####----H#####-
#d----------####
#D----------####
########H---####
#----##D------##
#---H##d------##
#----##D------##