-####--###--####M-M-##-##
-#M#M-###M--M###M-M-M#-##
#-MHM-###M--MH##MHM-MH###
#-M-M-###M--M-##M-M-M-###
#-M-M-#--M--M---M-MHM-#--
#-M-M-#--M--M---M-M-M-#--
#-M-MHH--MH-M---M-M-M-#--
#-M-M--H-M--M-H-M-M-M-#H-
#dM-M--#-M--M-#-M-M-M-##-
H#M-M--#-M--M-#-M-M-M-H#-
-#M-M--#-M--M-#-M-M-M--#-
HHM-M-##-M--M-#-MHM-M-H#-
#-M-MH##-MH-M-#-M-M-M-##-
#-M-M-##-M--M-#-M-MHM-##-
#-MHM-##DM--MH#DM-M-MH##D
####M--##M--####M-M-#####