#D----------####
########H---####
#MMMMMMMMMMMMMM#
#H-----------H##
#MMMMMMMMMMMMMM#
--H--------H----
MMMMMMMMMMMMMMMM
----H--------H--
MMMMMMMMMMMMMMMM
#D----------####
########H---####
#H-----------H##
#MMMMMMMMMMMMMM#
-####----H#####-
#D----------####
########H---####
#D----------####
########H---####
-####----H#####-
---H-----H------
MMMMMMMMMMMMMMM#
#H-----------H##
#MMMMMMMMMMMMMM#
#---H##d------##
#----##D------##