---D------------
####---------###
----------------
------####------
----------------
----------------
####--------####
####--------####
####--------####
#######-----####
####--------####
#TTTTTTTT---####
####--------####
####--##########
####--------####
----------------
----------------
-----TTTT-------
----------------
##----------####
##----------####
########H---####
####------######
----------------
########--------