---#HHH---------
---d###---------
---D------------
####---------###
----------------
MMMMMMMMMMMMMMMM
--------------#-
------------TTTT
--------------#-
----------------
---------#------
----------------
----------------
---#------------
----------------
--------TTTT----
----------------
---------####---
----------------
----------------
------TTTT------
----------------
####----------##
####-----------#
############---#