-####------####-
-####------####-
-####----H#####-
----------------
--TTTTTTTT------
----------------
--------------#-
------------TTTT
--------------#-
----------------
####--------####
#TTTTTTTT---####
####--------####
####--##########
####--------####
----------------
----------------
-----TTTT-------
----------------
---H-----H------
MMMMMMMMMMMMMMM#
----------------
####----------##
####-----------#
############---#