-T######-############-###
-T######-#####Dd#####-###
-T######-#####---########
-T######-#####---#---####
-T##-----#---#---#---##--
-T#------#---#---#---##--
-T#------#---#---#-------
-T#------#---#---#-----H-
-T#------T-------#-----#-
-T----#--T-------#-----#-
#-----#----------#-----#-
#-----#----------#-----#-
-----###---#######---###-
-----###---#######---###-
-----#############Dd#####
-----####################