MMMMMMMM#MMMMMMM
----------------
----------------
-----TTTTTTT----
---------####---
----------------
----------------
----------------
----------------
MMMMMMMMMMMMMMMM
----------------
TTTT------------
----------------
----------------
----------------
-----TT---------
----------------
-------#---#----
----------------
----------------
MMMMMMMM#MMMMMMM
----------------
---------TTTT---
----------------
-------------#--