---H-----H------
MMMMMMMMMMMMMMM#
----------------
----------------
------####------
----------------
####--------####
######------####
####--------####
#######-----####
####--------####
#TTTTTTTT---####
####--------####
####--##########
####--------####
----------------
----------------
-----TTTT-------
----------------
##----------####
########H---####
####------######
####------####--
####H-H#######--
####------####--