#---------------#-#------
----------------#-#-----#
----------------#-#-----#
----T----T------#-------#
----T----T--------------#
--#-T--T-T------------#H-
--#-T-------T---------#H-
--#---------T---------#H-
#H#--T----T-T---------##-
#H---T----T-T-T-----#H---
#H---T----T-T-TH----#H---
##---T----T-T-T-----#H---
#----T------T---#-#Dd#---
#----T------T---#-#------
#----T----------#-#------
#----T----------#-#------