--T----####------###-----
--T-------#---###########
--T-------M---###########
--T-------M---###--######
--T-------M---###---#####
-#T-------M---------#----
-#--------M---------H----
-#--------M-----H-------H
-#--------M-----#-------#
H----#----M-----#-------#
H----#--#-M-----#-------#
H----#----M---###---#####
#--#-#----M---###---#####
---#-#----M---###---#####
---#-#----M---###########
---#-#-####------###-----