----####--####--
----####-TTTTTTT
----####--####--
----####--####--
----####--####--
----####--####--
----####--####--
----####--####--
----####-TTTTTTT
-####------####-
-####------####-
-####------####-
-####----H#####-
##----------####
#MMMMMMMMMMMMM##
#--------------#
#----#---------#
#--------------#
----------------
---H-----H------
MMMMMMMMMMMMMMM#
----------------
----------------
#MMMMMMMMMMMMMM#
#--------------#