#---##----#########-#####
######----#########-M#--M
######----#########-MH--M
####-#----#########-M---M
-###-------#--------M---M
-#---------#--------M---M
-H---------#--------M---M
---H---T---#-T------M---M
---#---T---#-T------M---M
---#---T---#-T-#----M---M
---#---T-----T-#-#--M---M
-###---------T-#-#--M---M
-###------###T#####-M---M
-###------###T#####-M---M
######----###T#####-MH--M
#---##----#########-#####