---------##----#
---------------#
---------TTT##--
-------H--------
----------------
------TTT-------
----------------
-------------#--
----------------
----------------
---TTTT---------
--------------H-
####--------####
----------------
----------------
-------TT--TTTT-
----------------
----------------
-------TT-------
---------#------
-----H---#---H--
MMMMMMMMM#MMMMMM
----------------
---#------------
-H-#---H--------