---#HHH---------
---d###---------
---D------------
####---------###
----------------
MMMMMMMMMMMMMMMM
--------------#-
------------TTTT
--------------#-
----------------
---------#------
-----H---#---H--
MMMMMMMMM#MMMMMM
----------------
----TTTT--------
----------TTT---
----------------
----------T-----
----------------
TTTTTTTT--------
---------TTTT---
----------------
-------####-----
----#HHH--------
########-------#