#####----#------#-#------
#####----M------#-#-----#
#####----M------#-#-----#
#####----M------#-------#
---------M--------------#
T--------M------------#H-
---------MH-T---------#H-
-------T-M--T---------#H-
-------T-M--T---------##-
-#-#---T-M--T-T-----#H---
-#-#---T-M--T-TH----#H---
-#-#-----M--T-T-----#H---
#####----MH-T---#-#Dd#---
#####----M--T---#-#------
#####----M------#-#------
#####----M------#-#------