##------------D#
####--------####
----------------
----------------
####--------####
####--------####
####--------####
####-----TTTT###
####--------####
##------------##
##-----------###
##--TT-------###
##-----------###
##-----------###
##-----------###
-#######H--####-
-####------####-
-####------####-
-####----H#####-
#d----------####
#D----------####
########H---####
####------######
####------####--
####H-H#######--