----------------
#-------------##
----------------
----------------
---------####---
MMMMMMMM#MMMMMMM
--------------#-
----------------
----------------
---TTTT---------
----------------
----TTTT--------
----------TTT---
---------d------
---------D------
--------TTTT----
----------------
MMMMMMMMMMMMMMMM
----------------
---H-----H------
MMMMMMMMMMMMMMM#
----------------
----------------
#MMMMMMMMMMMMMM#
#--------------#