---##-----------
####----------##
####------######
---TTTT--TTTT---
----------------
MMMMMMMM#MMMMMMM
----------------
----H--------H--
MMMMMMMMMMMMMMMM
----------------
---H-----H------
MMMMMMMMMMMMMMM#
----------------
####------------
##-------------#
----------------
--TTTTTTTT------
----------------
----------------
----------------
#MMMMMMMMMMMMMM#
----------------
-----#----------
-----------#----
----------------