-###-#------#--M-M-------
-###-#------M--M-M----###
####-#------M--M-M----###
####-#------M--M-M----###
##-----T--T-M--M-M----###
##-----T--T-M--M-M-T--#--
-------T--T-MH-M-M-T--H--
--H----T--T-M--M-M------H
--#----T----M--M-M------#
--#----T----M--M-M-T----#
--#----T----M--M-M-T----#
--#---------M--M-M----###
###--#------MH-M-M----###
###--#------M--M-M----###
####-#------M--M-M----###
####-#------M--#-M-------