#---#--------------M--M--
H---M--------------M--M--
H---M--------------M--M--
H---M--------------M--M--
#---M--------------MH-MH-
----M--------------M--M--
----MH----------#--M--M--
#---M--------------M--M--
H---M--------------M--M--
H---M--------------M--M--
H---M--------------M--M--
H---M--------------M--M--
H---MH-----#-------M--M--
H---M--#-----------MH-MH-
#---M--------------M--M--
#---M--------------M--M--