----------------
--H--------H----
MMMMMMMMMMMMMMMM
----------------
--H--------H----
MMMMMMMMMMMMMMMM
--------------#-
------------TTTT
---------#------
----------------
----------------
----------------
----------------
----------------
----------------
-------TT--TTTT-
----------------
----------------
-------TT-------
---------#------
-----H---#---H--
MMMMMMMMM#MMMMMM
----------------
---#------------
-H-#---H--------