#--------------#
#H-----------H##
#MMMMMMMMMMMMMM#
----------------
------####------
----------------
----------------
------------TTTT
--------------#-
----------------
---------#------
-----H---#---H--
MMMMMMMMM#MMMMMM
----------------
--------TTTT----
----------------
----------------
--#-------------
----------------
---H-----H------
MMMMMMMMMMMMMMM#
----------------
----------------
#MMMMMMMMMMMMMM#
#--------------#