#---#----#-----###--#####
----M----M-----###--M#--M
----M----M-----###--MH--M
----M----M-----###--M---M
----M--T-M-----#----M---M
--#-M--T-M----------M---M
--#-MH-T-MH-T-------M---M
--#-M--T-M--T-#-----M---M
#H#-M--T-M--T-#--#--M---M
#H--M--T-M--T-#--#--M---M
#H--M--T-M--T-#--#--M---M
##--M----M--T-#--#--M---M
#---MH---MH-T----#--M---M
#---M----M--T----#--M---M
#---M----M-------#--MH--M
#---M----M-------#--#####