--#-----##-------T-M-----
--#-----##-------T-M-----
##########-------T-M----#
##-#######--T----T-M----#
##-######---T------MH---T
##-######---T------M----T
#---#-#---Dd-------M----T
#---#-#--H---------M-----
#---#-#--#---T-----M---H-
H---H-H--#---T-T---M-----
---------#---T-T---M-----
H---H-H--#---T-T---M-----
##-#######-----T-#-M-----
##-#######-------#-MH----
##########-------#-M-----
##########-------#-M-----