--------------#-
------------TTTT
####------------
####----#-------
####------######
MMMMMMMMMMMMMMMM
----------------
####--------####
#######-----####
####------T-####
##----------####
##-----------###
-#######H--####-
-----------#----
-####----H#####-
#d----------####
#D----------####
########H---####
####------######
####------####--
####H-H#######--
####------####--
####H-H#######--
####------####--
####H-H#######--