####H-H#######--
####------####--
####H-H#######--
####------####--
##-----------###
-#######H--####-
-####------####-
-####----H#####-
#d----------####
#D----------####
########H---####
####------######
----------------
---TTTT---------
--------------H-
####--------####
######------####
####--------####
##------------##
##-----####---d#
##------------D#
####--------####
##------------##
##----##########
##------------##