---M--M------###-M---#M--
---M--M--------M-M---#M--
---M--M--------M-MH--#M--
---M--M--------M-M----M--
---M--M--------M-M----MH-
---M--M--------M-M----M--
-#-M--M--------M-M----M--
-#-M--M--------M-M----M--
-#-M--MH-------M-M----M--
-#-M--M--------M-M----M--
---M--M--------M-M----M--
---M--M----#---M-MH---M--
---M--###------M-M---#M--
---M--M--------M-M---#MH-
---M--MH-------M-M---#M--
---M--M------###-M---#M--