-#######H--####-
-####------####-
-####----H#####-
----------------
----------------
------T---TT----
----------------
----------------
----------------
#MMMMMMMMMMMMMMM
----------------
---H-----H------
MMMMMMMMMMMMMMM#
----------------
---H-----H------
MMMMMMMMMMMMMMM#
----------------
-----TTTTTTT----
----------------
---H-----H------
MMMMMMMMMMMMMMM#
----------------
####--------####
#######-----####
####------T-####