#------M--##--T--###-----
----#--M--##--T-######---
----#--M--M#--T#######---
----#--M--M#--T##--###---
----#--MH-MH--T##---##---
--#H---M--M---T#----#----
--#H---M--M-H-T-----H-##-
--#H---M--M---T-H-------T
#H##---M--M----##-------T
#H-----M--M----##--------
#H-----M--M----##--------
##-----M--M----##---##---
#------M--MHH---#---##---
#------MH-M#----#---##---
#------M--M#----######---
#------M--##-----###-----