---d###---------
---D------------
##MMMMMMMMMMMMMM
----------##----
---######-------
----------------
#d-----------T##
#D------------##
#TTTT---H-----##
----------------
####----------##
####------######
####------####--
##-----------###
##-----------###
-#######H--####-
-####------####-
-####------####-
----------------
---H-----H------
MMMMMMMMMMMMMMM#
----------------
----------------
#MMMMMMMMMMMMMM#
#---H##d------##