#MMMMMMMMMMMMMM#
#--------------#
#--------------#
#H-----------H##
#MMMMMMMMMMMMMM#
----------------
----------------
----H--------H--
MMMMMMMMMMMMMMMM
----------------
---H-----H------
MMMMMMMMMMMMMMM#
----------------
####------------
##-------------#
##--------TTTTTT
#d-------------#
#D-------------#
#####---########
################
##----TT########
########H---####
####------######
----------------
########--------