-----------####-
-------#HHH-----
-------####-----
---#HHH---------
---d###---------
---D------------
####---------###
----------------
MMMMMMMMMMMMMMMM
----------------
-----TT--TT-----
----------------
#MMMMMMMMMMMMMMM
----------------
##----------####
##-----------###
-#######H--####-
-####------####-
-####----H#####-
##----------####
########H---####
####------######
####------####--
####H-H#######--
####------####--