####H-H#######--
####------####--
####H-H#######--
####------####--
##-----------###
-#######H--####-
-####------####-
-####----H#####-
----------------
#MMMMMMMMMMMMMMM
----------------
--------TTTT----
----------------
#----##-------##
#TT--##----#####
#---H##-------##
#----##-------##
#TT--##----#####
#---H##-------##
#----##-------##
#TT--##----#####
#---H##d------##
#----##D------##
#--TT--######--#
#------####----#