----------------
--H--------H----
MMMMMMMMMMMMMMMM
#------#-------#
--H--------H----
MMMMMMMMMMMMMMMM
----------------
####--------TTTT
MMMMMMMMMMMMMMMM
----------------
---#------------
-H-#---H--------
MMM#MMMMMMMMMMMM
----------------
---H-----H------
MMMMMMMMMMMMMMM#
----------------
------####------
----------------
------####------
----------------
----------------
---TTTT---------
----------------
----------------