----------------
----------------
----#-----------
----------------
-T--------------
----------------
-----#----------
-----------#----
----------------
-----#----------
-----------#----
##----------####
##--------------
####--------####
##------------##
----------------
####------------
####------------
####------------
----------------
#-----------TTTT
#--------------#
#--------------#
#--------------#
#########------#