--------------T-
----------------
----------------
--------------#-
----------------
----------------
-------#---#----
----------------
----------------
-------#---#----
----------------
----------------
---------#------
----------------
------####------
------##--------
########----####
----------------
-----#----------
-----------#----
##----------####
##-----------###
##########---###
####-----------#
############---#