----------------
---TTTT--TTTT---
----------------
----------------
----------------
----TTTT--------
----------TTT---
----------------
----------------
-----#--#--#----
----------------
##----------####
##--------------
----------------
####--------####
#######-----####
####--------####
#######-----####
####------T-####
##----------####
##----------####
##-----------###
##########---###
####-----------#
############---#