##-----------###
##--TT-------###
##-----------###
##########---###
####-----------#
############---#
###########----#
####----------##
####------######
----------------
--------####----
------######----
----------------
####--------####
##------------##
----------------
####------------
####------------
####------------
----------------
#-----------TTTT
#--------------#
#--------------#
#--------------#
#########------#