----------------
----------------
----------------
----#-----------
----------------
----------------
----------------
####------------
#--------T------
----------------
####----------##
########------##
############--##
##------------##
####--------####
#######-----####
####--------####
#######-----####
####------T-####
##----------####
##----------####
##-----------###
##########---###
####-----------#
############---#