----------------
----------------
----------------
------####------
----------------
----------------
----------------
------TTT-------
----------------
TTTT------------
----------------
-------#---#----
----------------
------T---TT----
----------------
----------------
----------------
----------------
----------------
----------------
------####------
----------------
-----TT---------
----------------
----------------