####H-H#######--
####------####--
##-----------###
-#######H--####-
-####------####-
-####----H#####-
----------------
---#------------
-H-#---H--------
MMM#MMMMMMMMMMMM
----------------
---H-----H------
MMMMMMMMMMMMMMM#
----------------
#-------------##
#MMMMMMMMMMMMM##
##--------------
----------------
-------####-----
---#HHH---------
---d###---------
---D------------
####---------###
----------------
####------------