-####----H#####-
----------------
#-------------##
#-------------d#
#-------------D#
#-----##########
####-----####---
####--------####
##------------##
##-----------###
-#######H--####-
-####------####-
-####----H#####-
#d----------####
#D----------####
########H---####
####------######
----------------
----H--------H--
MMMMMMMMMMMMMMMM
----------------
---H-----H------
MMMMMMMMMMMMMMM#
----------------
----------------