-####----H#####-
----------------
---H-----H------
MMMMMMMMMMMMMMM#
----------------
---H-----H------
MMMMMMMMMMMMMMM#
----------------
---H-----H------
MMMMMMMMMMMMMMM#
----------------
#MMMMMMMMMMMMMM#
----------------
##----------####
##----------####
########H---####
####------######
####------####--
####H-H#######--
####------####--
##-----------###
##-----------###
##########---###
####-----------#
############---#