#D----------####
########H---####
####------######
####------####--
####H-H#######--
####------####--
##-----------###
-#######H--####-
-####------####-
-####----H#####-
----------------
---------#------
---------#------
-----H---#---H--
MMMMMMMMM#MMMMMM
----------------
----------------
------TTTT------
----------------
----------------
---H---H--------
MMMMMMMMMMMMMMMM
----------------
MMMMMMMMMMMM#MMM
----------------