####--------####
##------------##
#TTTT---H-----##
#MMMMMMMMMMMMMMM
----------------
----H--------H--
MMMMMMMMMMMMMMMM
----------------
----------------
####----------##
####------######
####------####--
####H-H#######--
####------####--
##-----------###
##-----------###
-#######H--####-
-####------####-
-####----H#####-
----------------
---H---H--------
MMMMMMMMMMMMMMMM
----------------
MMMMMMMMMMMM#MMM
----------------