#-------------d#
#-------------D#
#-d---------####
#-D-----####----
TTTTTTTT--TTTTTT
----------------
####--------####
##------------##
#TTTT---H-----##
#MMMMMMMMMMMMMMM
----------------
----H--------H--
MMMMMMMMMMMMMMMM
----------------
----H--------H--
MMMMMMMMMMMMMMMM
----------------
---#------------
----------------
---H---H--------
MMMMMMMMMMMMMMMM
----------------
-------####-----
----#HHH--------
########-------#