MMMMMMMMMMMMMMM#
----------------
---H-----H------
MMMMMMMMMMMMMMM#
----------------
-----------####-
-------#HHH-----
-------####-----
---#HHH---------
---d###---------
---D------------
####---------###
----------------
##----------####
##----------####
##-----------###
-#######H--####-
-####------####-
-####----H#####-
#d----------####
#D----------####
########H---####
####------######
####------####--
####H-H#######--