####------####--
##-----------###
-#######H--####-
-####------####-
-####----H#####-
----------------
----H--------H--
MMMMMMMMMMMMMMMM
----------------
---H---H--------
MMMMMMMMMMMMMMMM
----------------
---H---H--------
MMMMMMMMMMMMMMMM
----------------
---H-----H------
MMMMMMMMMMMMMMM#
----------------
##----------####
##-----------###
-#######H--####-
-####------####-
-####----H#####-
----------------
####------------