---H-----H------
MMMMMMMMMMMMMMM#
----------------
---H---H--------
MMMMMMMMMMMMMMMM
----------------
MMMMMMMM#MMMMMMM
----------------
####----------##
####------######
####------####--
####H-H#######--
####------####--
##-----------###
-#######H--####-
-####------####-
-####----H#####-
----------------
---H---H--------
MMMMMMMMMMMMMMMM
----------------
#----##-------##
#TT--##----#####
#---H##d------##
#----##D------##