-####----H#####-
#d----------####
#D----------####
########H---####
####------######
----------------
---------#------
-----H---#---H--
MMMMMMMMM#MMMMMM
----------------
MMMMMMMM#MMMMMMM
----------------
##----------####
##-----------###
-#######H--####-
-####------####-
-####----H#####-
#d----------####
#D----------####
########H---####
####------######
####------####--
####H-H#######--
####------####--
####H-H#######--