#-M-M--M---M-------M---#-
H-M-M--M---M-------M---M-
H-M-M--MH--MH------MH--M-
H-#-M--M---M-------M---M-
#-M-M--M---M---#---M---M-
--M-M--M---M-------M---M-
--M-M--###-###-----###-MH
#-M-M--M---M-------M---M-
H-M-MH-M---M---#---M---M-
H-M-M--M---M-----T-M---M-
H-M-M--MH--MH----T-MH--M-
H-M-M--M---M-------M---M-
H-M-MH-M---M-------M---MH
H-M-M--M---M-------M---M-
#-M-M--M---M-------M---M-
#-M-M--M---M-------M---M-