----------------
---H-----H------
MMMMMMMMMMMMMMM#
----------------
----H--------H--
MMMMMMMMMMMMMMMM
----------------
---H-----H------
MMMMMMMMMMMMMMM#
----------------
----H--------H--
MMMMMMMMMMMMMMMM
----------------
MMMMMMMMMMMMMMMM
----------------
--H--------H----
MMMMMMMMMMMMMMMM
----------------
----------------
--------------T-
----------------
MMMMMMMMMMMMMMMM
----------------
MMMMMMMMMMMM#MMM
----------------