MMMMMMMMMMMMMMM#
----------------
---H-----H------
MMMMMMMMMMMMMMM#
----------------
---H-----H------
MMMMMMMMMMMMMMM#
----------------
---H-----H------
MMMMMMMMMMMMMMM#
----------------
#MMMMMMMMMMMMMM#
----------------
#MMMMMMMMMMMMMM#
----------------
##----------####
##-----------###
-#######H--####-
-####------####-
-####----H#####-
##----------####
########H---####
####------######
####------####--
####H-H#######--