----M-M--#--M-M--M--M--M-
----M-M--M--M-M--M--M--M-
----M-M--M--M-MH-M--M--M-
----#-M--M--M-M--M--M--M-
----M-M--M--M-M--M--M--MH
----M-M--M--M-M--M--M--M-
----M-M--MH-M-M--M--M--M-
-T--M-M--M--M-M--M--M--M-
----M-MH-M--M-M--MH-MH-M-
----M-M--M--M-M--M--M--M-
----M-M--M--M-M--M--M--M-
----M-M--M--M-MH-M--M--M-
----M-MH-MH-M-M--MH-MH-M-
----M-M--M--M-M--M--M--MH
----M-M--M--M-M--M--M--M-
----M-M--M--M-M--M--M--M-