#D----------####
########H---####
####------######
####------####--
##-----------###
-#######H--####-
-####------####-
-####----H#####-
----------------
----H--------H--
MMMMMMMMMMMMMMMM
----------------
#MMMMMMMMMMMMMMM
----------------
----H--------H--
MMMMMMMMMMMMMMMM
----------------
---H---H--------
MMMMMMMMMMMMMMMM
----------------
---H---H--------
MMMMMMMMMMMMMMMM
----------------
MMMMMMMMMMMM#MMM
----------------