----TTT---------
----------------
MMMMMMMM#MMMMMMM
----------------
---H---H--------
MMMMMMMMMMMMMMMM
----------------
MMMMMMMMMMMMMMMM
----------------
---H---H--------
MMMMMMMMMMMMMMMM
----------------
---H---H--------
MMMMMMMMMMMMMMMM
----------------
---H-----H------
MMMMMMMMMMMMMMM#
----------------
#MMMMMMMMMMMMMM#
----------------
#MMMMMMMMMMMMMM#
----------------
--H--------H----
MMMMMMMMMMMMMMMM
----------------