---H-----H------
MMMMMMMMMMMMMMM#
----------------
---H-----H------
MMMMMMMMMMMMMMM#
----------------
---H-----H------
MMMMMMMMMMMMMMM#
----------------
---H-----H------
MMMMMMMMMMMMMMM#
----------------
---H-----H------
MMMMMMMMMMMMMMM#
----------------
---H-----H------
MMMMMMMMMMMMMMM#
----------------
MMMMMMMM#MMMMMMM
----------------
##----------####
########H---####
####------######
----------------
########--------