#-M-M--M--M--#--M-####---
H-M-M--M--M--M--M-#######
H-M-M--M--M--M--M-#######
H-#-M--M--M--M--M-#######
#-M-M--M--M--M--M-#---###
--M-M--M--M--M--M-#---#--
--M-M--M--M--MH-M-----H--
#-M-M--M--M--M--M--H----H
H-M-MH-MH-MH-M--M--#----#
H-M-M--M--M--M--M--#----#
H-M-M--M--M--M--M--#----#
H-M-M--M--M--M--M--#--###
H-M-MH-MH-MH-MH-M-##--###
H-M-M--M--M--M--M-##--###
#-M-M--M--M--M--M-##Dd###
#-M-M--M--M--M--M-####---