---H---H--------
MMMMMMMMMMMMMMMM
----------------
MMMMMMMM#MMMMMMM
----------------
---H-----H------
MMMMMMMMMMMMMMM#
----------------
---H-----H------
MMMMMMMMMMMMMMM#
----------------
---H-----H------
MMMMMMMMMMMMMMM#
----------------
---H-----H------
MMMMMMMMMMMMMMM#
----------------
---------#------
-----H---#---H--
MMMMMMMMM#MMMMMM
----------------
#----##-------##
#TT--##----#####
#---H##d------##
#----##D------##