-#######H--####-
-####------####-
-####----H#####-
----------------
---H-----H------
MMMMMMMMMMMMMMM#
----------------
---H-----H------
MMMMMMMMMMMMMMM#
----------------
---H---H--------
MMMMMMMMMMMMMMMM
----------------
---H-----H------
MMMMMMMMMMMMMMM#
----------------
--H--------H----
MMMMMMMMMMMMMMMM
----------------
--H--------H----
MMMMMMMMMMMMMMMM
----------------
-------####-----
----#HHH--------
########-------#