---H-----H------
MMMMMMMMMMMMMMM#
----------------
---H-----H------
MMMMMMMMMMMMMMM#
----------------
---H-----H------
MMMMMMMMMMMMMMM#
----------------
---H-----H------
MMMMMMMMMMMMMMM#
----------------
---H-----H------
MMMMMMMMMMMMMMM#
----------------
#MMMMMMMMMMMMMM#
----------------
---------#------
-----H---#---H--
MMMMMMMMM#MMMMMM
----------------
---H-----H------
MMMMMMMMMMMMMMM#
----------------
##HHHHHH#--#HHH#