----H--------H--
MMMMMMMMMMMMMMMM
----------------
---H---H--------
MMMMMMMMMMMMMMMM
----------------
----H--------H--
MMMMMMMMMMMMMMMM
----------------
---H-----H------
MMMMMMMMMMMMMMM#
----------------
----H--------H--
MMMMMMMMMMMMMMMM
----------------
----H--------H--
MMMMMMMMMMMMMMMM
----------------
----H--------H--
MMMMMMMMMMMMMMMM
----------------
#----##-------##
#TT--##----#####
#---H##d------##
#----##D------##