----------------
---------#------
---------#------
----------------
TTTT------------
----------------
#MMMMMMMMMMMMMM#
----------------
------------####
------------##--
------####--##--
------------##--
---------#####--
---------##-----
------#####-----
------##--------
########----####
----------------
-----#----------
-----------#----
##----------####
##-----------###
##########---###
####-----------#
############---#