----------------
------TTT-------
----------------
---#------------
----------------
MMMMMMMM#MMMMMMM
----------------
-TTTT-----------
----------------
----------------
----------------
####----------##
####------######
----------------
####--------####
#######-----####
####--------####
#######-----####
####------T-####
##----------####
##----------####
##-----------###
##########---###
####-----------#
############---#