###--#---################
###--#---###--------####-
###------#-#-------------
###------#-#-------------
----T----#-#------#------
----T----#-#------#------
---------#--------#------
-----#####--------#------
-----#####--#--#-----#---
----T-T-----#--#-----#---
------T-----#--#-----#---
------------#--#-----#---
-----###############Dd###
-----#--T----------T-----
###--#-------T--T-----T--
###--#---################