##########---###
####-----------#
############---#
###########----#
####----------##
####------######
----------------
##----------####
##-----------###
##########---###
####-----------#
############---#
###########----#
####----------##
####------######
----------------
##----------####
########H---####
####------######
----------------
##----------####
##-----------###
##########---###
####-----------#
############---#