----####--####--
----####--####--
----####-TTTTTTT
----####--####--
----####--####--
----####--####--
----####-TTTTTTT
----####--####--
----####--####--
----####-TTTTTTT
----####--####--
----####--####--
----####--####--
----####-TTTTTTT
----####--####--
----####--####--
----####--####--
----#TTTT-####--
----------####--
----------------
####----------##
####------######
####------####--
####H-H#######--
####------####--