----------------
----------------
------####------
----------------
-----#----------
-----------#----
----------------
---####---------
----------------
TTTT------------
----------------
----------------
-----T----------
----------------
-------TT--TTTT-
----------------
----------------
----------------
----------------
----------------
------####------
----------------
---------#------
---------#------
-----H---#---H--