----------------
----#-----------
----------------
-T--------------
----------------
-----#----------
-----------#----
----------------
-----#----------
-----------#----
-----------#----
----------------
---#------------
----------------
#MMMMMMMMMMMMMM#
----------------
####------------
####------------
####------------
----------------
#-----------TTTT
#--------------#
#--------------#
#--------------#
#########------#