-----------#----
----------------
---------#------
----------------
----------------
-----T----------
----------------
----------------
----#-----------
----------------
----------------
-----#----------
-----------#----
----------------
#MMMMMMMMMMMMMM#
----------------
#MMMMMMMMMMMMMM#
----------------
##----------####
##----------####
##----------####
##-----------###
##########---###
####-----------#
############---#