----------------
------####------
----------------
----------------
----------------
TTTT------------
----------------
####--------####
####--------####
####--------####
----------------
MMMMMMMM#MMMMMMM
----------------
----------------
----------------
----------------
----------------
------TTT-------
----------------
----------------
----------------
##----------####
########H---####
####------######
####------####--