----------------
----------------
----------------
####----------##
####------######
####------####--
##-----------###
-#######H--####-
-####------####-
-####----H#####-
----------------
##------TTTTTT##
##------------##
####--------####
##------------##
----------------
####------------
####------------
####------------
----------------
#-----------TTTT
#--------------#
#--------------#
#--------------#
#########------#