----------------
##----------####
##--------------
----------------
-------####-----
-------TTTT-----
---------------#
----------------
##-----TTTT---##
##------------##
----------------
#######---------
----------------
##----------####
##----------####
##----------####
##-----------###
-#######H--####-
-####------####-
-####----H#####-
##----------####
##-----------###
##########---###
####-----------#
############---#