#####---####----------###
--##########----------###
--##########---######-###
----####-###---######-###
#----###-------######T--#
#----#---------######T--#
#-#--H-------#-------T--#
#-#----H-----#--T-------#
#-#----#-----#--T##-----#
#-#----#-----#--T#####--#
#-#----#--------T#####---
#-#--###--------######---
###--###----------#T#####
###--###-----------T--###
############-------T--###
#####---####----------###