----------M-----------M--
-----T----M-----------M--
----------M-----------MH-
----------M-----------M--
--#-------M-#---------M--
----------M-----------M--
----------M-----------M--
----------#-----------M--
----------M-#---------M--
----------M---T-------M--
---#------M---T-------M--
----------M-----------MH-
--------#-M-----------M--
----------M-----------M--
----------M-----------M--
----------M-----------M--