--------------T-
----------------
----------------
----------------
----#-----------
----------------
----------------
----------------
------TTT-------
----------------
----------------
----------------
----------------
----------------
----------------
----------------
----------------
----------------
----------------
---H---H--------
MMMMMMMMMMMMMMMM
----------------
MMMMMMMMMMMM#MMM
----------------
----------------