----------------
--------------#-
----------------
####----------##
####------######
----------------
MMMMMMMM#MMMMMMM
----------------
---------#------
---------#------
----------------
------####------
----------------
##----------####
##----------####
##----------####
##-----------###
-#######H--####-
-####------####-
-####----H#####-
##----------####
##-----------###
##########---###
####-----------#
############---#