----------------
--#-------------
----------------
MMMMMMMM#MMMMMMM
----------------
####--------####
####--------####
#######-----####
####------T-####
##----------####
##-----------###
##-----------###
##-----------###
##--TT-------###
##-----------###
##-----------###
##-----------###
-#######H--####-
-####------####-
-####------####-
-####------####-
-####------####-
-####------####-
-####----H#####-
#d----------####