MMMMMMMMMMMMMMMM
----------------
----#-----------
----------------
----------------
MMMMMMMMMMMMMMMM
--------------#-
----------------
-----#----------
-----------#----
----------------
-----#----------
-----------#----
----------------
-----#----------
-----------#----
----------------
----------------
---#------------
----------------
MMMMMMMMMMMMMMMM
----------------
--------------T-
----------------
#-------------##