-####------####-
-####----H#####-
----------------
---####--TTT----
---####---####--
-TTT###---####--
---#####--####--
----####--####--
----#TTTT-####--
----------####--
----------------
------####------
----------------
##----------####
##----------####
##----------####
##-----------###
-#######H--####-
-####------####-
-####----H#####-
##----------####
##-----------###
##########---###
####-----------#
############---#