#D----------####
########H---####
####------######
----------------
---####--TTT----
---###d---####--
-TTT##D---####--
---#####--####--
----####--####--
----####--####--
----####-TTTTTTT
----####--####--
----####--####--
----####--####--
----####-TTTTTTT
----####--####--
----####--####--
----####--####--
----#TTTT-####--
----------####--
----------------
####----------##
####------######
----------------
########--------