########H---####
####------######
####------####--
##-----------###
-#######H--####-
-####------####-
-####----H#####-
----------------
####--------####
####--------####
#TTTTTTTT---####
####--------####
####--##########
####--------####
####--------####
##------------##
########------##
############--##
##------------##
----------------
#-----------TTTT
#--------------#
#--------------#
#--------------#
#########------#