---------#------
----------------
-----TT---------
----------------
----------------
----------------
---------------#
----------------
---H-----H------
MMMMMMMMMMMMMMM#
----------------
---------#------
----------------
----------------
MMMMMMMM#MMMMMMM
----------------
----------------
----#-----------
----------------
---#------------
----------------
#-----------TTTT
#--------------#
#--------------#
#########------#