----#-----------
----------------
----------------
---#------------
----------------
----#-----------
----------------
----------------
MMMMMMMMMMMMMMMM
--------------#-
----------------
----------------
---H---H--------
MMMMMMMMMMMMMMMM
----------------
----------------
---#------------
----------------
####------------
----------------
#-----------TTTT
#--------------#
#--------------#
#--------------#
#########------#