----------------
MMMMMMMM#MMMMMMM
----------------
---------#------
----------------
---------------#
----------------
MMMMMMMM#MMMMMMM
----------------
-------#---#----
----------------
----#-----------
----------------
##----------####
##----------####
##----------####
##-----------###
-#######H--####-
-####------####-
-####----H#####-
##----------####
##-----------###
##########---###
####-----------#
############---#