----------------
---------#------
----------------
-------#---#----
----------------
-------#---#----
----------------
-------####-----
---#HHH---------
---d###---------
---D------------
####---------###
----------------
##----------####
##----------####
##----------####
##-----------###
-#######H--####-
-####------####-
-####----H#####-
##----------####
##-----------###
##########---###
####-----------#
############---#