----------------
---#------------
---------#------
---------#------
----------------
----------------
----------------
----------------
----------------
----------------
----------------
------TTTT------
----------------
----------------
---H---H--------
MMMMMMMMMMMMMMMM
----------------
---------#------
-----H---#---H--
MMMMMMMMM#MMMMMM
----------------
-------------#--
----------------
----------------
----------------