####--------####
####--##########
####--------####
#######-----####
####------T-####
##----------####
##----------####
########H---####
####------######
####------####--
##-----------###
##--TT-------###
##-----------###
##-----------###
##-----------###
-#######H--####-
-####------####-
-####------####-
-####----H#####-
##----------####
##--------------
##--------------
##--------------
#d--TTTT--------
#D--------------