#d-----------T##
#D------------##
#####-------####
################
################
####----------##
####------######
####------####--
####H-H#######--
####------####--
##-----------###
##-----------###
##--TT-------###
##-----------###
#d-----------###
#D-----------###
################
####----------##
####------######
----------------
####--------####
##TTTT------####
####--------d###
####--------D###
####----########