MMMMMMMMMMMMMMM#
----------------
---H-----H------
MMMMMMMMMMMMMMM#
----------------
MMMMMMMM#MMMMMMM
----------------
-----T----------
----------------
----------------
--------------T-
----------------
-------------#--
----------------
-------#---#----
----------------
----------------
----#-----------
----------------
---#------------
---#------------
----------------
#-----------TTTT
#--------------#
#########------#