MMMMMMMMMMMMMMMM
----------------
-------####-----
-------TTTT-----
---------------#
----------------
##----------####
##-----------###
-#######H--####-
-####------####-
-####----H#####-
----------------
----------------
--H--------H----
MMMMMMMMMMMMMMMM
----------------
TTT---------####
----------------
TTTTTTTT--------
---------TTTT---
----------------
------------####
-----------#####
----#####-------
----------------