----------------
----------------
---#------------
----------------
----------------
---H-----H------
MMMMMMMMMMMMMMM#
----------------
---H-----H------
MMMMMMMMMMMMMMM#
----------------
----------------
#MMMMMMMMMMMMMM#
----------------
####--------####
##------------##
####--------####
#######-----####
####------T-####
##----------####
##----------####
##-----------###
##########---###
####-----------#
############---#