---H-----H------
MMMMMMMMMMMMMMM#
----------------
---#------------
---------#------
---------#------
----------------
----------------
----------------
----------------
----------------
----------------
----------------
-------------#--
----------------
MMMMMMMMMMMMMMMM
----------------
-------#---#----
----------------
----------------
MMMMMMMM#MMMMMMM
----------------
----------------
MMMMMMMMMMMM#MMM
----------------