-------H--------
MMMMMMMMMMMMMMMM
----------------
####--------####
##------------##
##-----####---##
##------------##
##------------##
####--------####
##TTTT------####
####--------d###
####--------D###
####----########
####--------####
-----H----------
----TTT---------
----------------
MMMMMMMMMMMMMMMM
----------------
------####------
----------------
--TTTT----TTTT--
----------------
--TTTTTTTT------
----------------