#H-----------H##
#MMMMMMMMMMMMMM#
----------------
----------------
#-------------##
#-------------d#
#-------------D#
#-d---------####
#-D-----####----
TTTTTTTT--TTTTTT
----------------
------####------
----------------
####--------####
######------####
####--------####
####-T------####
#-----------d###
#-----------D###
#---T--#########
#--------------#
#########------#
##-------------#
##----------TTTT
#d-------------#