########H---####
####------######
####------####--
####H-H#######--
####------####--
##-----------###
##-----------###
-#######H--####-
-####------####-
-####----H#####-
----------------
#MMMMMMMMMMMMMM#
----------------
####--------####
##------------##
----------------
####------------
####------------
####------------
----------------
#-----------TTTT
#--------------#
#--------------#
#--------------#
#########------#