########H---####
####------######
####------####--
##-----------###
-#######H--####-
-####------####-
-####----H#####-
#d----------####
#D----------####
########H---####
####------######
----------------
##-----TTTT---##
##------------##
####----------##
####----------##
########------##
############--##
##------------##
----------------
#-----------TTTT
#--------------#
#--------------#
#--------------#
#########------#