##T#-############---M---#
--T-------#######---M---#
--T-------M#----M---M---#
--T-------M#----M---M---#
--T-------MH----M---M----
--T-------M-----M---M----
----------M-----M---M----
-----#----M-----M---M----
-----#----M-----M---M----
-----#----M-----M---M-T--
-----#----M-----M---M-TH-
-----#----M-----M---M-T--
----##----MH----#---M---#
----##----M#----#---M---#
Dd####----M#----#---M---#
#################---#---#