-####------####-
-####----H#####-
#d----------####
#D----------####
########H---####
####------######
####------####--
####H-H#######--
####------####--
##-----------###
-#######H--####-
-####------####-
-####----H#####-
##----------####
##--------------
----------------
####------------
####------------
####------------
----------------
#-----------TTTT
#--------------#
#--------------#
#--------------#
#########------#