-#######H--####-
-####------####-
-####------####-
-####------####-
-####------####-
-####------####-
-####------####-
-####------####-
-####----H#####-
##----------####
##-----------###
-#######H--####-
-####------####-
-####------####-
-####----H#####-
##----------####
########H---####
####------######
----------------
------------####
------------##--
----------####--
---------TTT##--
-------H--------
----------------