#---####------d#
#---########--D#
##------########
##----------####
##-----------###
-#######H--####-
-####------####-
-####----H#####-
#d----------####
#D----------####
########H---####
####------######
----------------
##-----TTTT---##
##------------##
####--------####
#######-----####
####------T-####
##----------####
########H---####
####------######
----------------
#-----------TTTT
#--------------#
#########------#