########H---####
####------######
####------####--
##-----------###
-#######H--####-
-####------####-
-####----H#####-
##----------####
##----------####
##-----------###
#d-----------###
#D-----------###
################
####---#####-###
#------------###
#-------------d#
#-------------D#
#-----##########
--------TTTTTTTT
----------------
#d-----------T##
#D------------##
#####-------####
################
################