----------------
---H-----H------
MMMMMMMMMMMMMMM#
----------------
---H-----H------
MMMMMMMMMMMMMMM#
----------------
---------------#
----------------
-------#---#----
----------------
MMMMMMMMMMMMMMMM
----------------
---------#------
----------------
MMMMMMMM#MMMMMMM
----------------
----------------
----#-----------
----------------
---#------------
----------------
####----------##
####-----------#
############---#