#----#---------#
#--------------#
#------#-------#
#-T------------#
#--------------#
#H-----------H##
#MMMMMMMMMMMMMM#
----------------
####MMMMMMMMMM##
#-------------##
#-------------##
#-------------##
#-------------##
###H-------H####
#MMMMMMMMMMMMM##
#--------------#
#--------------#
#--------------#
----------------
----------------
-----------####-
-------#HHH-----
-------####-----
----#HHH--------
########-------#