##------------##
##-----------###
##-----------###
-#######H--####-
-####------####-
-####----H#####-
#d----------####
#D----------####
########H---####
####------######
####------####--
####H-H#######--
####------####--
##-----------###
-#######H--####-
-####------####-
-####----H#####-
----------------
--------####----
------######----
----------------
#-------------##
#-------------##
#-------------##
#-------------d#