##MMMMMMMMMMMMMM
----------##----
-------#####----
----------------
####----------##
####------######
####------####--
####H-H#######--
####------####--
##-----------###
-#######H--####-
-####------####-
-####----H#####-
----------------
####----------##
####------######
####------####--
####H-H#######--
####------####--
##-----------###
-#######H--####-
-####------####-
-####----H#####-
----------------
####------------