#-------------##
#-------------##
#-------------##
#MMMMMMMMMMMMM##
##--------------
----------------
#MMMMMMMMMMMMMM#
----------------
---H-----H------
MMMMMMMMMMMMMMM#
----------------
----------------
----------------
----------------
---------TTTT---
----------------
----------------
-----#----------
-----------#----
----------------
---H---H--------
MMMMMMMMMMMMMMMM
----------------
MMMMMMMMMMMM#MMM
----------------