########H---####
####------######
----------------
----------------
----------------
---H-----H------
MMMMMMMMMMMMMMM#
----------------
----------------
--H--------H----
MMMMMMMMMMMMMMMM
----------------
----------------
----------------
----------------
-----TTTTTTT----
----------------
-----TTTT-------
----------------
----------------
----------------
----------------
--H--------H----
MMMMMMMMMMMMMMMM
----------------