---H---H--------
MMMMMMMMMMMMMMMM
----------------
MMMMMMMM#MMMMMMM
----------------
----H--------H--
MMMMMMMMMMMMMMMM
----------------
--TTTTTTTT------
----------------
------####------
TTTTTTTT--------
----------------
####--------####
----------------
---####---------
---##-----------
#####---------##
#-------------##
#MMMMMMMMMMMMM##
#--------------#
#H-----------H##
#MMMMMMMMMMMMMM#
#--------------#
#--------------#