#D----------####
########H---####
####------######
----------------
---H-----H------
MMMMMMMMMMMMMMM#
----------------
----H--------H--
MMMMMMMMMMMMMMMM
----------------
----H--------H--
MMMMMMMMMMMMMMMM
----------------
##----------####
##--------------
----------------
####------------
####------------
####------------
----------------
#-----------TTTT
#--------------#
#--------------#
#--------------#
#########------#