-#######H--####-
-####------####-
-####----H#####-
#d----------####
#D----------####
########H---####
####------######
----------------
##-----TTTT---##
##------------##
##-----------###
-#######H--####-
-####------####-
-####----H#####-
#d----------####
#D----------####
########H---####
####------######
----------------
##-----TTTT---##
##------------##
##-----------###
##########---###
####-----------#
############---#