MMMMMMMM#MMMMMMM
----------------
----------------
----H--------H--
MMMMMMMMMMMMMMMM
----------------
----#-----------
----------------
----------------
MMMMMMMMMMMMMMMM
--------------#-
----------------
MMMMMMMMMMMMMMMM
----------------
----H--------H--
MMMMMMMMMMMMMMMM
----------------
----------------
---#------------
----------------
----------------
#MMMMMMMMMMMMMM#
#--------------#
#--------------#
#########------#