----------------
---#------------
---------#------
---------#------
-----H---#---H--
MMMMMMMMM#MMMMMM
----------------
----------------
MMMMMMMM#MMMMMMM
----------------
---H---H--------
MMMMMMMMMMMMMMMM
----------------
---H---H--------
MMMMMMMMMMMMMMMM
----------------
--TTTTTTTT------
----------------
----------------
-------####-----
----#HHH--------
########-------#
---------------#
----------------
----------------