#MMMMMMMMMMMMMM#
#--------------#
#--------------#
#H-----------H##
#MMMMMMMMMMMMMM#
----------------
----------------
----------------
##----------####
##--------------
##MMMMMMMMMMMMMM
----------##----
--TTTT----------
----------------
----H--------H--
MMMMMMMMMMMMMMMM
----------------
----------------
----------------
---------#######
----------------
----H--------H--
MMMMMMMMMMMMMMMM
----------------
####----------##