-####----H#####-
----------------
MMMMMMMM#MMMMMMM
----------------
---H---H--------
MMMMMMMMMMMMMMMM
----------------
--TTTTTTTT------
----------------
----------------
----------------
#MMMMMMMMMMMMMM#
----------------
-----#----------
-----------#----
##----------####
##-----------###
-#######H--####-
-####------####-
-####----H#####-
----------------
-------####-----
---#HHH---------
---d###---------
---D------------