-####----H#####-
----------------
--TTTTTTTT------
----------------
---H-----H------
MMMMMMMMMMMMMMM#
----------------
---H-----H------
MMMMMMMMMMMMMMM#
----------------
---H-----H------
MMMMMMMMMMMMMMM#
----------------
----------------
#MMMMMMMMMMMMMM#
----------------
#MMMMMMMMMMMMMM#
----------------
##----------####
##----------####
##----------####
##-----------###
##########---###
####-----------#
############---#