----------------
----------------
##----------####
##-----------###
-#######H--####-
-####------####-
-####----H#####-
#d----------####
#D----------####
########H---####
####------######
----------------
MMMMMMMMMMMMMMMM
----------------
----------------
----------------
---------#######
----------------
----H--------H--
MMMMMMMMMMMMMMMM
----------------
---H-----H------
MMMMMMMMMMMMMMM#
----------------
----------------