----------------
---H-----H------
MMMMMMMMMMMMMMM#
----------------
##----------####
##-----------###
-#######H--####-
-####------####-
-####----H#####-
----------------
----------------
##-----TTTT---##
##------------##
##------------##
##-----------###
-#######H--####-
-####------####-
-####----H#####-
----------------
----------------
---H---H--------
MMMMMMMMMMMMMMMM
----------------
MMMMMMMMMMMM#MMM
----------------