#D----------####
########H---####
####------######
####------####--
##-----------###
-#######H--####-
-####------####-
-####----H#####-
----------------
####--------####
-----H----------
----TTT---------
----------------
MMMMMMMMMMMMMMMM
----------------
#-------------##
#MMMMMMMMMMMMM##
##--------------
----------------
----------------
-----------####-
-------#HHH-----
-------####-----
----#HHH--------
########-------#