#d----------####
#D----------####
########H---####
####------######
----------------
---H---H--------
MMMMMMMMMMMMMMMM
----------------
##----------####
##-----------###
-#######H--####-
-####------####-
-####----H#####-
##----------####
##--------------
##--------------
##--------------
##MMMMMMMMMMMMMM
----------##----
-------#####----
----------------
#----##-------##
#TT--##----#####
#---H##d------##
#----##D------##