-----H---#---H--
MMMMMMMMM#MMMMMM
----------------
-----TT---------
----------------
---H-----H------
MMMMMMMMMMMMMMM#
----------------
##----------####
##-----------###
-#######H--####-
-####------####-
-####----H#####-
#d----------####
#D----------####
########H---####
####------######
####------####--
####H-H#######--
####------####--
##-----------###
##-----------###
##########---###
####-----------#
############---#