##-----------###
-#######H--####-
-####------####-
-####----H#####-
#d----------####
#D----------####
########H---####
####------######
####------####--
##-----------###
-#######H--####-
-####------####-
-####----H#####-
----------------
####--------####
##----TTTTTTTT##
##------------##
----------------
#-------------##
#MMMMMMMMMMMMM##
#--------------#
#H-----------H##
#MMMMMMMMMMMMMM#
#--------------#
#--------------#