-####----H#####-
#d----------####
#D----------####
########H---####
####------######
####------####--
##-----------###
-#######H--####-
-####------####-
-####----H#####-
#d----------####
#D----------####
########H---####
####------######
----------------
----------------
---H---H--------
MMMMMMMMMMMMMMMM
----------------
####--------####
####-----TTTT###
####--------####
####--------####
####--------####
####-T------####