-########----#######-M---
-#DDD####----M#----M-M---
-#-----------MH----M-M---
-#-----------M-----M-M---
#------------M-----M-M---
#---------T--M-----M-M---
#---------T--M-----M-M---
#------------M-----M-#-#-
-------------M-----M-M-##
----------T--M-----M-M--H
----------T--M-----M-M-#H
-------------M-----M-M-#H
-------------M-----M-M-##
DD-----------M-----M-M-##
-------------MH----M-M-##
#########----#######-M-##