------M---###############
------M---###########DD##
------M---###########---#
-T--T-M---#DDDDDD####---#
-T--T-M---#--------------
-T--T-M---#-----------#--
----T-M---#-----------#--
------M---#-----------#--
--T---MH--------------#--
--T---M------------#-----
--T---M--#-------T-#-----
--T---M----------T-#-----
------###########T###---#
------M---#######T###---#
------MH--###############
------M---###############