--M---#-------#---####---
--M---M----####---#######
--M---M----##############
--M---M----###-##########
--M---M----###-####---###
--M---M----#---####---#--
--M---MH---H----#-----H--
--M-T-M------H--#--H----H
T-M-T-M------#--#--#----#
T-M-T-M------#--H--#----#
T-M---M------#-----#----#
T-M---M----###--H--#--###
--M---MH-#-###-#####--###
--M---M----###-#####--###
--M---M----#########Dd###
--#---M-------########---