#####################----
##DDD#########DD##------#
##---#########---#------#
##-----#----##---#------#
###---##-----##---------#
##----##-----##----#--#H-
##----##-----##----#--#H-
##----##-----##----#--#H-
###---##------##---##H##-
##-----#------##----#H---
##-----#------##----#H---
##-----#------##----##---
#-----##-----------##----
------##-----------##----
------##DDD###-----##----
##################-##----