##########---######-M-M--
-#####-------#DDD##-M-M--
-----#--#----#----M-M-M--
-----#--###--#----M-M-M--
-----#--#DD--#----M-M-MH-
-----#--#----#----M-M-M--
--------#----#----M-M-M--
--------#----#----M-M-M--
--#---###----#----M-M-M--
--#---###---##----M-M-M--
--#---#-----#-----M-M-M--
--#---#-----#-----M-M-M--
#DD####-----#-----#-M-M--
T-----------------#-M-MH-
---T--------------#-M-M--
###################-M-M--