-------T-################
-------T-#DD######-------
-----T-T-#----####-------
-----T-T-#------##-------
-----T-T#------###-------
-----T-T#------###-------
-#------#------###-------
-#-#----#------###-------
-#-#---T-------##--------
-#-#---T--------#--------
---#-T-T--------#--------
---#-T-T--------##-------
---#-T-T-------###-------
-----T-TDD-----###-------
-------T-------###DDDDDDD
-------T#################