##-------#-##############
D#--T-####-####DD##DDDDD#
----T-#########---#------
----T-###-#####---#------
--T-T-###-##--##--##-----
--T---#---##--##--#------
--T---H-------##--#------
--T-T---H---H-##--#------
#---T---#---#--##-##-----
#-------#---#--##-#------
#-------#---#--##-#------
#-----###---#--##-#------
------###-###------------
------###-###------------
------#########----------
##-------################