--------#-###########---#
#########-###############
#########################
########-###############-
########-##----------###-
---------##----------#---
---------------------H---
-------H---H-----------H-
-------#---#-----------#-
-------#---#-----------#-
-------#---#-----------#-
########---#---------###-
########-###---------###-
########-###---------###-
############DDDDDDDDD####
--------#############---#