########################-
DDD#####################-
-------T################-
-------T###DDDDDDDDDD###-
#------T--#--------------
-------T--#--------------
-------T--#--------------
-------T--#--------------
#------T-----------------
-------T-----------------
---------------------T---
---------------------T---
---###--#############T##-
---###--#############T##-
---#####################-
########################-