--------#######----#-####
--------############-####
#########################
###################-#####
#########------####-##---
#########------#----##---
#-#-#-#--------H---------
#-#-#-#--H--------H---H--
#-#-#-#--#--------#---#--
H-H-H-H--#--------#---#--
---------#--------#---#--
H-H-H-H--#-----####---#--
##########-----####-###--
##########-----####-###--
##########DDDDD########DD
###############----######