###-M------------###-----
###-M------------###-----
###-M-#######----#-------
###-M-#######----#----T--
----M-T######T---#----T--
----M-T######T--------T--
----M-T------T-----------
----M---T-------#--------
----MH--T##-----#------T-
#---M---T#####--#------T-
#---M---T#####--#------T-
#---M---######--#------T-
###-M-----#T##-----#-----
###-M------T-------#-----
###-M------T-------#-----
###-M--------------#-----