#########################
################---####--
-------------------------
--#--#--#--#------------#
--#--#--#--#-----#------#
--#--#--#--#-----#------#
--#--#--#--#-----#------#
-----------------#-------
--------------------#----
--------------------#----
--------------------#----
--------------------#----
###################DD####
---T--T--T--T-----T-----T
T-------------T------T---
#########################