-------#----T-T--#T------
-------M----T#T#--T------
-------M---TT-T---T------
-------M---TT-T---T------
---T-T-M---T-------------
---T-T-M---T-------------
---T---MH--T-------------
---T---M---T----------T--
-------M---T-------------
-----T-M---T-------------
-------M-----------------
-#-----M-----------------
-------MH----------------
-------M-----------------
-------M-----------------
-------M---------##------