-------M-----------------
-------M-----------------
#------M--------------#--
#------M-----------------
#T-----MH----------------
#T-----M----------------T
-T-T---M------------T----
---T---M------------T---#
---T---M------------T----
##-T-#-M------------T----
##---#-M------------T----
##---#-M------------T----
##---#-M-----T-##---T----
-----#-MH----T------T----
-----#-M-----T-----------
-----#-M-----T-----------