##---------------M-------
-#-----T---------M-------
-----------------MH------
#----T------#----M-------
#----T------#-#--M-------
#----T------#----M-------
#----T------#----M----#--
#--T-------------M----#--
#--T-------------M----#--
-#-T-------------M--T-#--
-#-T-----------#-M--T----
T--T------T------MH-T----
T--T------T------M--T----
---T------T------M-------
---T------T------M-------
##---------------M-------