----------------------###
----------------------###
----------------------###
------T-----#---------###
------T-----#------------
------T-----#------------
---T--T-----#------------
---TDDD-T----------------
T--T---------------------
T--T----------T---T-#----
T-------------T---T-#----
T---------#---T-----#----
--------------T-----#--##
-----------------------##
-----------------------##
-----------------------##