#---------#-#------------
#---------#-#------------
#-------###-#---------###
#-------###-------T---###
#-------#---------T---T##
#-----###-------#-T---T##
------###-------#-----T--
------#---------#--------
--#####---------#--T-H---
--#####-------#H---T-----
--#-----------#H---T-----
###-----------#H---T-----
###---------#Dd#---------
#-----------#------------
#-----------#------------
#-----------#------------