--#-----#######----------
#-#----#####------#------
#-#-----H###------#------
#-#-T--#H---------#-#----
#-#-T--#HT--------#-#----
--#-T--#H----#--#H--#----
--#----#H----#--#H--#----
-------#H----#--#H-------
-----T-##----##H##-------
-----T--------#H--------T
-----T-T------#H--------T
-----T--------##---------
-------------##-------T--
-------------##-------T--
-------------##-------T--
-------------##-------T--