############------------M
--------####------------M
--T--T----#-------------M
-------#--#-----------#-M
-------#--#-----------#-M
----####--------------#-M
----####--------------#-M
----####--------#-------M
########--------#-------M
####----####----#-------M
T-------####----#-------M
-------T-H------#-T-----M
--T----T--------#-T#----M
--T-H-----T-------T-----M
--####----T-------T-----M
--##########------------#