#####---M--T---------####
#####H--M--T-------#-####
#--T#---M-TT-------#-####
#--T#---#-TT----#--#-#T##
---T----M-T--#--#--#--T-#
---T----M-T-----#--#--T-#
---T----M-T-----#--#--T-#
-H-T----M-T--------#----#
---T----M-T--#-----#----#
---T--T-M-T-------------#
------T-M----------------
-T----T-M---------#------
#T--#-T-M---------#--####
#T--#---M---------#--####
#T###---M---------#--####
#####---M------------####