############-----####----
############H----####H---
-----#######-----####----
-----#####T#-----####----
-#--------T--------------
-#--------T--------------
-#--------T--------------
-#-----------------------
-##----------------------
-##----------T-T------T--
-##---#------T-TH--T--T--
-##---#------T-T---T--T--
-##--#######-T---##T#-T--
-##--#######-----##T#----
############-----####----
############-----####----