#########---#############
#########---#########Dd##
-T#######---#########----
-T##T####---###Dd####----
-T--T---------#-----#----
-T--T---------#-----#----
-T--T---------#-----#----
-T------------#-----#----
-T-----------------------
-T--------T--------------
----------TH-----T-------
----------T------T-------
--#######---#####T######-
--#######---#####T######-
#########---#############
#########---#############