-#--------M-----------T--
-#--------M---T-------T-#
-#--------M-----------T--
-#--------M-----------T--
----T-----MH-------------
----T---T-M--------------
----T---T-M---------#----
----T-----M-------T------
----------M-------T------
------#-T-M-----#-T------
H-----#-T-M-----#-T------
------#---M-----#--------
-#----#---M-----#-----#--
-#--------MH----------#--
-#--------M-----------#--
-#--------M-----------#--