---------M------#-----##-
---------M------M-----###
---------MH-----M-----#--
---------M------M--#--#--
------##-M------M--#--#--
-------#-M------M--#-----
-------#-M----T-MH-#-----
###----#-M----T-M----#---
-------#-M----T-M----#---
-------#-M----T-M----#---
-------#-M--T-T-M----#---
-------#-MH---T-M----#--#
--##-----M----T-MH------#
--##-----M----T-M-------#
--##-----M------M-------#
--##-----M------M-------#