--####---##--M-----M-----
--#D##---##--M-----M-----
--#------##--M-----M-----
###------##--M-----M-----
###---T--#---M-----MH----
###---T------M-----M-----
###---T------M--T--M-----
--#---T-#----#--T--M-----
--#-----#----M--T--M-----
--#-----#----M--T--M-----
--------#----M-----M-----
--------#----M-----M-----
##-----------M-----M---T-
##-----------M-----MH--T-
##-----------M-----M---T-
######-------M-----M---T-