#######--T-M------------#
---------T-M------------#
-----#---T-M--------T---#
-#---###-T-M---T--T-T---#
-#---#DD-T-M---T--T-T----
-#---#---T-M---T--T-T----
-#---#-----M---T--T------
-----#-----M-------------
---###-----MH-----------#
---###-----M----------#-#
---#-------M----------#-#
---#-------M----------#-#
####-----T-###--------#-#
-T-------T-M------------#
---------T-MH-----------#
#########T-M------------#