------#########---T---#--
------###DD####---T---M--
------###-----T---T---M--
T-----###-----T---T---M--
T-------------T---T-T-M--
T---------#---T---T-T-M--
----------#---T-#-T-T-M--
----------#---T-#-T-T-M--
-T--------#-----#-----M--
-T--T-----------#-----M-T
-T--TH----------------M-T
-T--T-----------------M--
------###-------------M--
------###-------------M--
------#########-------M--
------#########-------#--