###-------------#---####-
--M-----T-------#H--####H
--M-----T-------#---####-
--M--T--T-T-#---#---#T##-
--M--T--T-T-#--------T---
--M--T----T-#--------T---
--M-------T-#--------T---
#-M-----T----------------
#-M---T-T----------------
#-M---T---T---T---T------
#-M---T---T---TH--T------
#-M---T---T---T---T------
#-M-------T-----#-T-####-
#-M-------------#---####-
#-M-------------#---####-
###-------------#---####-