###---#----------T-#####-
###H--#----------T--####-
###---#----------T--M#-M-
###---##---------T--M#-M-
-------#------#--T--MH-M-
-------#------------M--M-
-------###----------M--M-
-------###----------M--M-
---------#----------M--M-
-#--T----###--------M--M-
-#--T----###---#----M--M-
-#--T------#--------M--M-
###-T-T----##----T--MH-#-
###---T----##----T--M#-#-
###---T----------T--M#-#-
###---T----------T-#####-