#########-------######---
##-----##-------######---
-------###############---
---------#############---
---#-----########--------
--##-----########--T-----
--##---#--#-#-#---------T
--##---#--#-#-#--H------T
--##---#--#-#-#--#------T
--##---#--H-H-H--#--#---T
--##---#---------#--#---T
--##---#--H-H-H--#--#----
########-#########-###---
########-#########-###---
######################---
######################---