#-----###################
#-----###################
################----#-###
-###############----#-###
-######-------------#---#
-######--T----------#---#
--#-#-------------------#
--#-#--H--------H-------#
--#-#--#-----------------
--H-H--#--#---#----------
-------#--#-T-#-----#----
--H-H--#--#-T-#-T---#----
-#######-###T###T---#-###
-#######-###T###T---#-###
################T########
#########################