#####----M--#----------#-
----#----M--#----------#-
-T-------M--#----------#-
---#--T--M--##-----------
---#--T--MH--#-----------
####--T--M---#-----------
####--T--M---#Dd#-T-T----
####-----M---####-T-T----
####-----M--------T-T----
----#----M--------T-T----
----#----M--------T------
---T-----M------T--------
---T-----M--T----------#D
H--------MH-T----------#-
##-------M--T----------#-
#####----M--T----------#-