---T--T------------#-----
---T--T------------M-----
###T##T####--------M----#
###T##T####--------M----#
###T##T####T---##--M----T
###T##T####T----#--M----T
---T--T----T----#--MH---T
-T--------------#--M-----
-T#######-------#--M---H-
-T#######DD#----#--M-----
-T##########----#--M-----
-###########----#--M-----
--------#T##-T-----MH----
---------T---T-----M-----
---------T---T-----M-----
-------------T-----M-----