######---------##########
######H----------------##
###--#--------T--T--T----
###--#-----T--T-------#--
----------------------#--
----------T--------####--
----------T--------####--
---H---------------####--
------------###########Dd
-#-----T-------####----##
-#-----T--T----T-------##
-#-T---T--T--T--------T-H
###T-#-T-----T---T----T--
###T-#-----------T-H-----
###T##-----------####----
######-----------########