----------#--##########--
----------#--###DD#####H-
######----#--###---T###--
######----#--#T#---T#T#--
######T---#---T----T-T---
######T---#---T--#-T-T---
------T---#---T--#-T-T---
-T-----T---------#-T-----
-T##---T---------#-T-----
-T##DD#T-----------T----T
-T#####-----------------T
-######-----------------T
---#T##------###----###-T
----T--------###----###--
----T--------##########--
-------------##########--