---####----#######-------
---###############-------
############---------##--
###########--------------
####---####--#-----###---
####---#-----#-----------
-#-----H-----#-----------
-#--H-----H--#-----###--#
-#--#-----#--##---------#
-H--#-----#--##---------#
----#-----#--##----###--#
-H--#--####--##------T--#
#####--####--#####---T--#
#####--####--#####-###---
#####Dd###########-T-----
#######----#######-T-----