---------#---######T#--M-
##########---####--T---M-
##############-##--T---M-
#########-####-##--T---M-
#########-####-##--T---M-
----------####-##--T---M-
-----------#---##------M-
--------H--#---##------M-
--------#--#---#-------M-
--------#--H---#-------M-
--------#------#-------M-
#########--H---##------M-
#########-#######----###-
#########-#######----###-
#################DD######
---------################