------------M---#----#-M-
------------M---M----M-M-
------T-----M---M----M-M-
------T-----M-T-M----M-M-
-#----T---#-M-T-M----M-M-
------T-----M-T-M----M-M-
---#--------M-T-MH---M-M-
----------#-#---M--T-M-M-
-#----------M---M----M-M-
------------M---M----M-M-
------T---#-M---M----M-M-
------T-----M---M----M-M-
------T-----M---MH---M-M-
------T-----M---M----M-M-
------------M---M----M-M-
------------M---M----#-#-