###------M----##---------
#D#------M---------#-----
#--------MH--------#-----
#--------M---------#-----
#--------M---------#-----
#--------M-------#H------
#------#-###-----#H------
#------#-M-------#H------
-------#-M-----#H##---#-H
----T--#-M-----#H-----#--
----T----MH----#H-----#--
----T----M-----##-----#--
###-T----M-----#---------
###------M-----#---------
###------M-----#---------
###------M-----#---------