#########---------##-T---
#DDD#####H---------M-T---
#---#####----------M-T---
#-----###----------M-T---
#------------------M-T---
#------------------M-T---
#--------------T---M-T---
------------#--T---M-T---
------------##-T---M-----
----------T--H-T---M----T
----------T-#H-----M----T
-----T----T-#H-----M----T
-----T-##-T-#####--M-----
-----T-##---#####--M-----
-------##---#####--M-----
-------##---#####-##-----