###########-----T---#####
#######DD##-----T---#DD##
#######---------T---#----
###DD##---------T---#----
--#------------TT--------
--#-----#-T----TT-----#--
--#-----#-T-T--TT-----#-#
--#-----#-T-T--TT-----#-#
--------#-T-T--T------#-#
------------T--T--#-----#
-----T---------T--#-----#
-----T---------T--#-----#
#####T#-----------#-#---#
#####T#-------T-----#---#
###########---T-----#####
###########---T-----#####