#########---############-
#########-----------####-
-#--#--#---T--T--T----#--
-#--#--#---T-------#--#--
-#--#--#-----------#--#--
----------------####-----
----------------####-----
----------------####-----
d--------###########Dd--#
#########---####----####-
#########---T-------####-
H--H--H---T--------T-H---
----------T---T----T-----
-T--T--T------T-H-----T--
-T--T--T------####----T--
#########-----##########-