--##########-###----#----
###-----####-########----
--------#################
---#--------########-####
---#--------##--####-####
-###--------##--#----####
-###----#-------H-----#-#
-#------#-----H----H--#-#
-#------#-----#----#--#-#
-#------#-----#----#--H-H
--------#-----#----#-----
--------#-----#-####--H-H
----#####---###-####-####
----#####---###-####-####
###-###########D#########
###-############----#####