#####---###----##########
-####---################D
-#######################-
-----##########-----####-
-----####--####--------##
-----####--#-----------##
-#----#----H-----------##
-#----#--H----H--------##
-#----#--#----#---------#
-#----H--#----#---------#
-#-T-----#----#---T-----#
-#-T--H--#-####---T-----#
##---#####-####----------
##---#####-####----------
##########D#############-
###########----##########