----###-----M---------M--
----###-----M-------T-M--
----###-----MH------T-MH-
----###-----M---T---T-M--
-------###--M---T---T-M--
------------M---T-----M--
------------M---T-#---###
------------M-----#D--M--
-T----------M----T#---M--
-T----------M----T#---M--
-T--------#-M----T--T-MH-
-T----------MH---T--T-M--
------------M----T--T-M--
------------M----T--T-M--
DD#####-----M----T----M--
#######-----M----T----M--