####---############------
####-----------####------
--#---T--T--T----#-------
--#---T-------#--#-------
--#-----------#--#-------
-----------####----------
-----------####----------
-----------####----------
DD--###########DD--------
####---####----####--T---
####---T-------####--T---
-H---T--------T-H--------
-----T---T----T----------
--T------T-H-----T-------
--T------####----T-------
####-----##########------