###########-----#####-###
----#######-----M#----###
-T----#--#------MH----###
---#--#--#---#--M-----###
---#--#--#---#--M-----##-
####---------#--M-----##-
####---------#--M-----##-
####------------M-----##-
####DD----------M---#-##-
----#######-----M-----##-
----#######-----M-----##-
---T-H--H-------M-----##-
---T------------M----##--
H-----T--T------M--T-----
##----T--T------MH---#---
###########-----#########