###########---###########
----#######-----------###
-T----#--#---T--T--T----#
---#--#--#---T-------#--#
---#--#--#-----------#--#
####--------------####---
####--------------####---
####--------------####---
####Dd-----###########Dd-
----#######---####----###
----#######---T-------###
---T-H--H---T--------T-H-
---T--------T---T----T---
H-----T--T------T-H-----T
##----T--T------####----T
###########-----#########