--M--M-----M---------M---
--M--M-----M---------M---
--M--M-----MH--T-----M---
--M--#-----M---T---#-M---
--MH-M-----M---T---#-M---
--M--M-----M---T---#-M---
--M--M-#-T-M-------#-M---
--M--M-#-T-M---------M---
--M--M-#-T-M---------MH--
--M--M-#-T-M-----#---M---
--M--M-----M---T-#---M---
--M--M-----MH--T-#---M---
--M--M-----M---T-#---###-
--MH-M-----M---T-----M---
--M--M-----M---------MH--
--M--M-----M---------M---