###---M-----M-------M--M-
###---M-----M-------M--M-
###---MH----MH------MH-M-
###---M--T--M-------M--M-
#-##--M--T--M-------M--MH
#-##--M--T--M-------M--M-
#-##--M--T--####----M--M-
#-##--M-----M---T---M--M-
#--##-M-----M---T---M--M-
#--##-M-----M-------M--M-
#--##-M-----MH------M--M-
#--##-MH----M-------MH-M-
----#-M-----M-------M--M-
----#-M-----M-------M--MH
----#-M-----M-------M--M-
#####-M-----M-------M--M-