---##---#-----------#----
---##---#-----#-T---#----
---##---#-----#-T---#----
---##---------#-T--------
------T-------#-T--------
------T-----#H----------#
------T-----#H----------#
------T-----#H--T-T-----#
T-----------##--T-T-----#
T---------#H------T---#H-
T---------#H------T---#H-
T---------#H----------#H-
--------#DD#--------#DD#-
--------#-----------#----
D####---#-----------#----
#####---#-----------#----