#######-----############-
###---------#DDD####DD##-
--#--#------#------#---M-
--#--###----#------#---M-
--#--#DD----#------##--M-
--#--#------#------#---M-
-----#------#------#---M-
-----#------#------#---M-
---###------#------##--M-
---###-----##------#---M-
---#-------#-------#---M-
---#-------#-------#---M-
####-------#-----------#-
-----------------------#-
T----------------------#-
########################-