-################-###----
-################---M----
-##########-----T---M----
-#####DDD##---------M----
-----#--------------M----
-----#--------------M----
-----#--------------M----
---T-#-----H--#-----M---T
---T----------#-----M----
---T----------#-----M----
H--T-----T----#-----M----
---T-----T-T--T-----M----
-##T#####T#T--T-----M----
-##T#####T#T--T-----M----
-##T#######T###DD---M----
-################-###----