----T--M-####-----##---##
----T--M-###########---##
----T--M-################
----T--#-#########--#####
----T--M-#---#####--####-
-------M-#---#------####-
----T--M-----H-------#---
----T--M--H------H---#--H
-T--T--M--#------#---#--#
-T--T--M--#------#---H--#
-T-----M--#------#------#
-T-----M--#--#####---H--#
-------M-##--#####--#####
-------M-##--#####--#####
Dd#----M-##Dd############
#####--M-####-----#######