----###-#####---#####----
#######-#############H---
#####################----
####---#########-####----
####---##----###---------
-------##----#----T------
-------------H-----------
---H-----H-----H---------
---#-----#-----#---------
---#-----#-----#---#--T-T
---#-T---#-----#---#--T-T
####-T---#---###---#--T--
####---###---###--###-T--
####---###---###--###----
##########DDD########----
----#########---#####----