-----T------M--M---####--
-----T------M--M---M#-M--
-----T---T--M--MH--MH-M--
-----T---T--M--M---M--M--
-----T---T--MH-M---M--M--
-----T---T--M--M---M--M--
------------M--###-M--M--
------------M--M---M--M--
-T----------M--M---M--M--
-T-----#----M--M---M--M--
-T-----#----M--MH--M--M--
-T-----#----M--M---M--M--
-----T-#----M--M---M--M--
-----T------MH-M---M--M--
Dd##-T------M--M---MH-M--
#####T------M--M---####--