-----M--M---#####------M-
-----M--M----####H---T-M-
-----MH-M----####------MH
-----M--M----#D##------M-
-----M--MH---#---------M-
-----M--M----#---------M-
####-M--M----#---------##
-----M--M----#---------M-
-----M--M----#---------M-
-----M--M---------T----M-
-----M--M------T--T----MH
-----MH-M----T----T----M-
-----M--M------##-T----M-
-----M--MH-----##------M-
-----M--M------##------M-
-----M--M---#####------M-