--#######-------#########
----#####H-------M#-M#-M#
----#####--------MH-MH-MH
----#Dd##--------M--M--M-
----#------------M--M--M-
----#------------M--M--M-
----#---------T--M--M--M-
--#-#---------T--M--M--M-
#-#-#---------T--M--M--M-
H-#-------T-T-T--M--M--M-
H-#----T--T-T-T--M--M--M-
H-#-T-----T-T-T--M--M--M-
###----##-T-T-T--M--M--M-
###----##-----T--M--M--M-
###----##--------MH-MH-MH
#########-------#########