##################-M----#
-----#############-M---##
--T----#--#--#--#--M----H
----#--#--#--#--#--M---#H
----#--#--#--#--#--M---#H
-####--------------M---#H
-####--------------M---#H
-####--------------M---#H
#####Dd------------MH--##
#----#############-M-----
-----#############-M---T-
----T-H--H--H--H---M-----
----T--------------MH----
-H-----T--T--T--T--M-----
###----T--T--T--T--M-----
##################-M-----