-M-----------#-----####--
-M-------#####-----######
-MH------################
-M-------####-###########
-M-------####-######---##
-M-------#----######---#-
-###---#-H-----#-#-----H-
-M-----#----H--#-#--H----
-M-----#----#--#-#--#----
-M-----#----#--H-H--#----
-MH---------#-------#----
-M-------####--H-H--#--##
-M-------####-#######--##
-M-------####-#######--##
-M-------############Dd##
-M-----------##########--