-----T-######-#-
----------------
------####------
------##--------
########----####
------------####
------------##--
----------####--
----------------
---####---------
----------------
----TTTT--------
----------TTT---
----------------
----########----
-----------#----
----------------
------TTT-------
---------#######
------------TTTT
####------------
########--------
#---########----
#-------########
#-----------####