#-T#----------##
#--#-----####-##
#--#----------##
#--#---#########
--T#---##-------
---#---##-------
---#-TT##-------
####---##-----##
####---##---TT##
####TT-##-----##
####---##-----##
####---##---TT##
####TT-##-----##
####---##-----##
####---##---TT##
####TT-##-----##
####---##-----##
------T---TT----
----------------
------####------
----------------
---------TTT----
----------------
----------------
----------------