#--#-----------#
#-T#-----####--#
#--#-----------#
#--#----------##
#T-#----------##
#--#----------##
#-T#----------##
#--#-----####-##
#--#----------##
#-T#----------##
#--#-----####-##
#--#----------##
#T-#----------##
#--#----------##
#--#---#########
--T#---##-------
---#---##-------
---#-TT##-------
####---##-----##
####---##---TT##
####TT-##-----##
####---##-----##
####---##---TT##
####TT-##-----##
####---##-----##