----------------
----------------
----------------
----------------
----------------
---------#------
---------#------
----------------
--------TTTT----
----------------
----------------
----------------
-----TT---------
----------------
----------------
--TTTT----TTTT--
----------------
---#------------
-TTTT-----------
----------------
-----------TTTT-
----------------
------####------
----------------
----------------