----------------
----------------
------TTTT------
----------------
----------------
TTT---------####
----------------
-----#--#--#----
----------------
-----T----------
----------------
----------------
----------------
----------------
----------------
---TTTT---------
----------------
--------TTTT----
----------------
-------TT--TTTT-
----------------
-------#---#----
----------------
----------------
--------TTTTTTTT