---------------#
----------------
----------------
-----#--#--#----
----------------
----------------
----TTTT--------
----------------
TTTT------------
----------------
------####------
----------------
----------------
------####------
----------------
----------------
---------#######
----------------
----------------
--------T-------
----------------
----------------
####--------####
##------------##
####--------####