----##---#-####---####---
-#########-##############
-########################
-###-####-########---####
-###--###-##---###----###
-#----#---##---#------#--
-H----H--------H------H--
---H----H---H----H------H
---#----#---#----#------#
---#----#---#----#------#
---#----#---#----#------#
-###--###---#--###----###
-###--###-###--###----###
-###--###-###--###----###
-############Dd##########
----##---######---####---