TTTTTTTT--------
---------TTTT---
----------------
--------TTTT----
----------------
MMMMMMMM#MMMMMMM
----------------
----TTTT--------
----------TTT---
----------------
----------------
---------#######
----------------
########----####
------------####
------------##--
------------##--
---------#####--
---------##-----
------#####-----
------##--------
---#####--------
---##-----------
####----------##
########------##