----------------
----------------
----------------
----TTTT--------
----------------
----T---##------
--------#d------
--------#D------
--------#####---
-----------##---
####-------#####
--##-----------#
--#####--------#
-----##--------#
-----#####-----#
---------##----#
---------##----#
---------------#
------##########
------##--------
########----####
----------------
------TTT-------
----------------
####----########