#######--M----###T----T--
#######--M-------T----T--
#---#-#--M-------T----T--
----#-#--M-------T----T--
----#----MH-T--------TT--
--#-#----M--T--------TT--
--#------M--T--------TT--
--#------M--T--------TT--
--#------M-----------T---
---------M-----------T---
----#----M-----------T---
----#----M-----------T---
----#-#--M--------------T
----#-#--MH---------T---T
#######--M----------T---T
#######--M----####--T---T