-H-#---H--------
MMM#MMMMMMMMMMMM
----------------
---TTTT---------
----------------
----TTTT--------
----------TTT---
----------------
---TTTT--TTTT---
----------------
--TTTTTTTT------
----------------
----------------
####--------TTTT
----------------
----------------
#######---------
----------------
------------####
------------####
-----------#####
-------#########
------TTTTTTTTTT
----##----------
######-------###