----TTT---------
----------------
-----#----------
-----------#----
##----------####
########H---####
####------######
----------------
#----##-------##
#--TT--######--#
#------####----#
##-----####--T-#
##H----####----#
##----##-------#
##TT--##-----T-#
------##-------#
-----T##-------#
-------#----TT--
---TT--#--------
-------#--------
------------T---
----TT---TT-----
----------------
----------------
########--------