------##--------
########----####
------------####
####------------
####HHH#--------
######-##-------
----------------
------####------
----------------
---------TTTT---
----------------
------####------
----------------
####----------##
####----------##
####------######
####------####--
####H-H#######--
####------####--
##-----------###
##--TT-------###
##-----------###
##########---###
####-----------#
############---#