####--------####
#TTTTTTTT---####
####--------####
------------####
------##########
------d#--------
------D#--------
########----####
------------####
------##########
------d#--------
------D#--------
########----####
------------####
------##########
------##--------
------##--------
########----####
----------------
-----TTTTTTT----
----------------
####--------####
####--##########
####--------####
####--------####