##--#####################
----##Dd########Dd#-----#
----##--########---------
----##---#---###---------
----###--#-----#----#----
----##---------#---##----
----##---#-----#---##----
----##---#T----#---##----
##--###--#T--------##----
#---##---#T--------##----
#---##----T--------##----
#---##----T-T------##----
#-###-----T-T-###########
#---------T-T-###########
#-##------T---###########
###########---###########