#----##-------##
#TT--##----#####
#---H##d------##
#----##D------##
#--TT--######--#
#------####----#
##-----####--T-#
##H----####----#
##----##-------#
##TT--##-----T-#
------##-------#
-----T##-------#
-------#----TT--
---TT--#--------
-------#--------
------------T---
----TT---TT-----
----------------
-----TT---------
----------------
----------------
-------#---#----
----------------
----------------
####----########