########-------#
####---####----#
---------------#
-####--------###
TT----------####
----------------
#----##-------##
#TT--##----#####
#---H##d------##
#----##D------##
#--TT--######--#
#------####----#
##-----####--T-#
##H----####----#
##----##-------#
##TT--##-----T-#
------##-------#
-----T##-------#
-------#----TT--
---TT--#--------
-------#--------
#----##-------##
#--TT--######--#
#------####----#
##-----####--T-#