####----------##
#-------------d#
#-------------D#
#-----##########
####-----####---
####--------####
##------------##
##-----------###
##--TT-------###
##-----------###
##-----------###
-#######H--####-
-####------####-
-####------####-
-####----H#####-
##----------####
##-----------###
##-----------###
##########---###
####-----------#
---------####--#
##-------##---##
##----#####---#-
##------------#-
#####---------#-