###########---M---####-M-
###########---M-----#H-M-
####--#-#-----M-----#H-M-
####--#-#-----#-----#H-M-
------#-#-----M-----##-M-
------#-#-T-T-M--------M-
------#---T-T-M-#--T---M-
----H-#---T---M-#---##-M-
------#---T---M-#---#H-M-
------#-----T-M-#---#H-M-
-#------#---T-M-----#H-M-
-#--T---#-----M-----#H-M-
####T---#-----M-----#H-M-
####T---#-----M-----#H-M-
####T######---M-----##-M-
###########---M------#-#-