---#-TT##-------
####---##-----##
####---##---TT##
####TT-##-----##
####---##-----##
####---##---TT##
####TT-##-----##
####---##-----##
------T---TT----
----------------
----------------
----TTTT--------
----------TTT---
----------------
#----##-------##
#TT--##----#####
#---H##-------##
#----##-------##
#TT--##----#####
#---H##d------##
#----##D------##
#--TT--######--#
#------####----#
##-----####--T-#
##H----####----#