-----#----#####-#########
-----##########-#########
-----####################
-----#####-----##########
------####-----##------#-
------#--------##---T--#-
------H----------------#-
---------H-------H-----#-
-T-------#-------#-----#-
-T-------#-------#---#-#-
-T-------#---T---#---#---
-T----####---T---#---#---
------####-----###--#####
------####-----###--#####
Dd#######################
######----###############