####--------####
##----TTTTTTTT##
##------------##
#TTTT---H-----##
#MMMMMMMMMMMMMMM
----------------
####--------####
##TTTT------####
####--------d###
####--------D###
####----########
####--------####
##------------##
##-----####---##
##------------##
##------------##
##------------##
######----######
##------------##
########------##
############--##
##------------##
##----##########
##------------##
#TTTT---H-----##