MMMMMMMM#MMMMMMM
----------------
##------TTTTTT##
##------------##
####----------##
########------##
##----#####---##
#d------------##
#D------------##
#####-------####
################
################
####----------##
####----------##
########------##
############--##
##------------##
##-----------###
##-----------###
##-----------###
-#######H--####-
-####------####-
-####----H#####-
----------------
---####--TTT----