------------------M--M-M-
------------------M--M-M-
------------------MH-M-M-
------------------M--M-M-
---T-T------------M--M-M-
---T-T------------M--M-M-
-----T------------M--M-M-
-----T------------M--#-#-
-T----------------M--M-M-
-T-T---------T----M--M-M-
-T-----------T----M--M-M-
-T--------#-------MH-M-M-
-T-----#----------M--M-M-
-T----------------M--M-M-
-T----------------M--M-M-
-T----------------M--M-M-