#----######-----M---M----
#---####------#-M---M----
-----H##------#-M---M----
----#H--------#-M---M-T--
----#HT-------#-M---M-T--
----#H---#--#H--M---M-T--
----#H---#--#H--M---M----
----#H---#--#H--M---M----
----##---##H##--M---M--T-
--#-------#H----M-#-M--T-
--#-T-----#H----M-#-M--T-
--#-------##----M-#-M--T-
#-#------##-----M-#-M----
#-#------##-----M---M----
#-#------##-----M---M----
#-#------##-----#---M----