----#TTTT-####--
----------####--
----------####--
---------TTT##--
-------H--------
MMMMMMMMMMMMMMMM
----------------
---TTTT---------
----------------
---TTTT---------
--------------H-
####--------####
####-----TTTT###
####--------####
-----H----------
----TTT---------
----------------
----------------
####------------
####HHH#--------
######-##-------
----------------
####----------##
####----------##
####-----------#