----##----------
######-------###
------------##--
------------##--
----------####--
----------####--
---------TTT##--
-------H--------
----------------
-----TTTT-------
----------------
-----------TTTT-
----------------
MMMMMMMMMMMMMMMM
----------------
#----##-------##
#TT--##----#####
#---H##-------##
#----##-------##
#TT--##----#####
#---H##d------##
#----##D------##
#--TT--######--#
#------####----#
##-----####--T-#