##TT--##-----T-#
------##-------#
-----T##-------#
-------#----TT--
---TT--#--------
-------#--------
#----##-------##
#TT--##----#####
#---H##-------##
#----##-------##
#TT--##----#####
#---H##-------##
#----##-------##
#TT--##----#####
#---H##-------##
#----##-------##
#TT--##----#####
#---H##-------##
#----##-------##
#TT--##----#####
#---H##-------##
#----##-------##
#--TT--######--#
#------####----#
##-----####--T-#