########-M-------T-------
----####-M-------T-------
-T----#--M-######T######-
---#--#--M-######T######-
---#--#--M-T#####T######T
####-----M-T#####T######T
####-----M-T-----T------T
####-----M----T----------
####Dd---MH---T#######---
----####-M----T##########
----####-M----T##########
---T-H---M----###########
---T-----M-----------#T##
H-----T--M------------T--
##----T--M------------T--
########-M---------------