-#---------------M-M-----
-M--#------------M-M-----
-M---------------M-M-----
-M----T----------M-M-----
-M----T----------M-MH----
-M----T----------M-M-----
-MH--------------M-M-----
-M-------T-------#-M---T-
-M-----T---T-----M-M---T-
-M-----T---T--T--M-M---T-
-M-----T---T--T--M-M---T-
-M-----T---T--T--M-M-----
-MH-----------T--M-M-----
-M---------------M-MH----
-M---------------M-M-----
-M---------------M-M-----