-------------##-----M-###
-------------##H----M-###
-------------##-----M-M#-
#------T-----##-----M-M#-
#------T-----------#M-MH-
#------T-----------#M-M--
#Dd#---T------------M-M--
####----------------M-M--
-----T--------------M-M--
-----T-T---T----T---M-M--
-----T-T---TH---T-T-M-M--
---T-T-T---T----T-T-M-M--
-------T-----##-T-T-M-MH-
-------------##---T-M-M#-
-------------##-----##M#-
-------------##-----#####