----------------
----------------
#MMMMMMMMMMMMMMM
----------------
----------------
----------------
--------dTTTT---
--------D-------
------####------
----------------
-------TT-------
----------------
#----##-------##
#TT--##----#####
#---H##-------##
#----##-------##
#TT--##----#####
#---H##d------##
#----##D------##
#--TT--######--#
#------####----#
##-----####--T-#
##H----####----#
##----##-------#
##TT--##-----T-#