##--TT-------###
##-----------###
-#######H--####-
-####------####-
-####------####-
-####------####-
-####------####-
-####------####-
-####----H#####-
#d----------####
#D----------####
########H---####
####------######
####------####--
####H-H#######--
####------####--
##-----------###
#d-----------###
#D-----------###
################
####----------##
####-----------#
---------####--#
##-------##---##
##----#####---#-