####---############----M-
####-----------####----M-
--#---T--T--T----#-----MH
--#---T-------#--#-----M-
--#-----------#--#-----M-
-----------####--------M-
-----------####------T-M-
-----------####------T-M-
Dd--###########Dd----T-M-
####---####----####--T-M-
####---T-------####--T-M-
-H---T--------T-H----T-MH
-----T---T----T------T-M-
--T------T-H-----T---T-M-
--T------####----T-----M-
####-----##########----M-