----------------
#-------------##
#-------------##
#---####------d#
#---########--D#
##------########
##----------####
##----------####
##----------####
##-----------###
##--TT-------###
##-----------###
-#######H--####-
-####------####-
-####------####-
-####----H#####-
#d----------####
#D----------####
########H---####
####------######
----------------
--H--------H----
MMMMMMMMMMMMMMMM
----------------
--------------#-