-----T-######-#-
----------------
----------------
####MMMMMMMMMM##
#-------------##
####----------##
####------######
####------####--
####H-H#######--
####------####--
####H-H#######--
####------####--
####H-H#######--
####------####--
####H-H#######--
####------####--
##-----------###
##-----------###
-#######H--####-
-####------####-
-####----H#####-
----------------
----TTTT--------
----------TTT---
----------------