####--------####
#######-----####
####------T-####
##----------####
########H---####
####------######
####------####--
####H-H#######--
####------####--
####H-H#######--
####------####--
##-----------###
-#######H--####-
-####------####-
-####----H#####-
##----------####
##----TT########
##--------------
##MMMMMMMMMMMMMM
----------##----
-------#####----
----------------
----------------
MMMMMMMMMMMM#MMM
----------------