##------------##
##-----####---d#
##------------D#
####--------####
#TTTTTTTT---####
####--------####
####--------####
#######-----####
####------T-####
##----------####
##-----------###
-#######H--####-
-####------####-
-####----H#####-
#d----------####
#D----------####
########H---####
####------######
####------####--
####H-H#######--
####------####--
##-----------###
##--TT-------###
##-----------###
-#######H--####-