----------------
---H---H--------
MMMMMMMMMMMMMMMM
----------------
MMMMMMMM#MMMMMMM
----------------
---------TTTT---
----------------
--------TTT-----
----------------
TTTT------------
----------------
--H--------H----
MMMMMMMMMMMMMMMM
----------------
#----##-------##
#TT--##----#####
#---H##d------##
#----##D------##
#--TT--######--#
#------####----#
##-----####--T-#
##H----####----#
##----##-------#
##TT--##-----T-#