##-----------###
-#######H--####-
-####------####-
-####----H#####-
##----------####
##----------####
########H---####
####------######
####------####--
##-----------###
-#######H--####-
-####------####-
-####----H#####-
----------------
------------####
--TTT--------###
-------------###
-----------T-###
-------#HHHHHH##
-----T-######-#-
----------------
-----------####-
-------#HHH-----
-------####-----
---#HHH---------