------#-----###-M-----M--
#######-----###-M-----M--
###############-M-----MH-
######-########-M-----M--
######-######---MH----M--
#------######---M-----M--
H-------#-#-----M--#--###
-----H--#-#--H--M--#--M--
-----#--#-#--#--M--#--M--
-----#--H-H--#--M--#--M--
-----#-------#--M-----MH-
######--H-H--#--M-----M--
######-#######--M-----M--
######-#######--MH----M--
###############-M-----M--
------#########-M-----M--