##---M--------#-------###
##---M----#####-------###
-M---M----###############
-M---M----####-##########
-M---M----####-########--
-M-T-M----#----########--
-M-T-M----H-----#-#-#----
-M---M-------H--#-#-#--H-
-M---MH------#--#-#-#--#-
-M-T-M-------#--H-H-H--#-
-M-T-M-------#---------#-
-M---M----####--H-H-H--#-
-#---MH---####-#########-
-#---M----####-#########-
-#---M----###############
##---M--------###########