-#---####----#-###-----M-
##---#########-###-----M-
##################-----MH
#-###########-####-----M-
#-####---####-##--#--T-M-
--####---#----##-----T-M-
---#-----H-----------T-M-
H--#--H-----H---H----T-M-
#--#--#-----#---#------M-
#--H--#-----#---#------M-
#-----#-----#---#--#---M-
#--H--#--####---#------MH
#-#####--####-###------M-
#-#####--####-###------M-
#######Dd#########-----M-
-########----#####-----M-