----------------
---------#------
-----H---#---H--
MMMMMMMMM#MMMMMM
----------------
--------TTTT----
----------------
---H---H--------
MMMMMMMMMMMMMMMM
----------------
----------------
---------#------
---------#------
---------#------
-----H---#---H--
MMMMMMMMM#MMMMMM
----------------
---------TTTT---
----------------
---H-----H------
MMMMMMMMMMMMMMM#
----------------
---TTTT---------
--------------H-
####--------####