----------------
----------------
----TTTT--------
----------TTT---
----------------
---------TTTT---
----------------
---H-----H------
MMMMMMMMMMMMMMM#
----------------
---H---H--------
MMMMMMMMMMMMMMMM
----------------
--H--------H----
MMMMMMMMMMMMMMMM
----------------
####--------####
----------------
----------------
----------------
####MMMMMMMMMM##
#-------------##
###H-------H####
#MMMMMMMMMMMMM##
#--------------#