XXXXXXXXXXXXXXX
XXXXXXX--XXXXXX
XXXXXXX---XXXXX
XXXXXXX----XXXX
------------XXX
XX-----------&-
XX----------XXX
XXXXXXX----XXXX
XXXXXXX---XXXXX
XXXXXXX--XXXXXX
XXXXXXXXXXXXXXX