--------XXXXXXX
--------XXXXXXX
----&---XXXXXXX
--------XXXXXXX
--------XXXXXXX
--------XXXXXXX
--------XXXXXXX
#-------XXX----
---------------
-----------XX--
--------XXXXXXX