^^^^^^^^^^--XXX
------------XXX
-------X----XXX
XXX---XX----XXX
X*X--XXX----XX-
X&---X#*----XX-
X*X--XXX-------
XXX---XX----XXX
/\\----X----XXX
\//---------XXX
^^^^^^^^^^--XXX