^^^^^^^^^^--^^^
----*-------^^^
------------^^^
^--^^^------^^^
^^^^^^^^----^^^
----&---------^
^^^^^^^^-------
^--^^^------^^-
------------^^^
----*-------^^^
^^^^^^^^^^--^^^