----^^^^^^^^^^^
---------------
---------------
----------X----
----------X-&-&
----------XXXXX
-#--------X-*#*
----------X----
---------------
---------------
----^^^^^^^^^^^