-----^^^^^^^^^^
---------------
X--------X--X--
XXX-----XX--XX-
-XX----XXX--XXX
-XX----X#*--*#X
-XX----XXX--XXX
#XX-----XX--XX-
-XX------X--X--
-XX------------
-XX--^^^^^^^^^^