---------------
---------------
---------------
---------------
---------------
---#--&--&--&--
---------------
/\\------------
\//------------
---------------
*--------------