XXXXXX--XXXXXXX
XXXXXX--XXXXXXX
XXXXXX--XXXXXXX
XXXXXX--XXXXXXX
XXXX---------#X
XXXX----------X
-*--------*----
XXXXXX--XXXXXXX
XXXXXX--XXXXXXX
XXXXXX--XXXXXXX
XXXXXX--XXXXXXX