--XXXXXXXXXXXXX
--XXXXXXXXXXXXX
--XXXXXXXXXXXXX
--XXXXXXXXXXXXX
--XX-----#XXXX-
--XX------XXXX-
------*----*---
--XXXXXXXXXXXXX
--XXXXXXXXXXXXX
--XXXXXXXXXXXXX
--XXXXXXXXXXXXX