-XXXXXXXXXXXXXX
-XXXXXXXXXXXXXX
-XXXXXXXXXXXXXX
-XXXXXXXXXXXXXX
-------#XXXXXXX
--------XXXXXX-
----#----*-----
-XXXXXXXXXXXXXX
-XXXXXXXXXXXXXX
-XXXXXXXXXXXXXX
-XXXXXXXXXXXXXX