XXXXXXXXXXXXXXX
#XXXXXXXXXXXXXX
-XXXXXXXXXXXXXX
-XXXXXXXXXXXXXX
----------#XXXX
---XXXXX---XXXX
---XXXXX----*--
-XXXXXXXXXXXXXX
-XXXXXXXXXXXXXX
-XXXXXXXXXXXXXX
XXXXXXXXXXXXXXX