---------------
---------------
-------------#-
---------------
---------------
---#-----&-----
---------------
/\\------------
\//------------
------*-------/
*-------------\