XXX--XXX-------
XXX--XXX-------
XXX--XXX---XX--
XXX--XXX---XXXX
XXX--XXX-----XX
XXXXXXXXXX---XX
XXXXXXXXXX---XX
XXXXXXXXXX---XX
X*XXXX*XXX---XX
-------------XX
-#----#------XX