^^--XXXXXXXXXXX
^^--XXXXXXXXXXX
^^--XXXXXXXXXXX
^^--XXXXXXXXXXX
^^----#XXXXXXXX
^^-----XXXXXXX-
^^------*------
----XXXXXXXXXXX
&---XXXXXXXXXXX
^^--XXXXXXXXXXX
^^--XXXXXXXXXXX