---#----XXXXXXX
---XX---XXXXXX-
---XX---XXXXXX-
---XX---XXXXXX-
---XX-----*----
---------------
---XX------#---
#--XX---XXXXXX-
---XX---XXXXXX-
---XX---XXXXXX*
---#----XXXXXXX