--^^^--------^^
--^^^--*-----^^
--^^^-----&--^^
--^^^--------^^
--^^^----------
--^^^----------
---&---------^^
-------------^^
--^^^--------^^
--^^^--------^^
--^^^--------^^