----^^^---X----
----^^^--------
----^^^---X----
----^^^---XX---
^---^^^---XXX--
^^--------&#X--
^---^^^---XXX--
----^^^---XX---
----^^^---X----
----^^^--------
----^^^---X----