---^--XXXXXXXXX
------XXXXXXXXX
------XXXXXXXXX
------XXXXXXXXX
--------*---#XX
#------------XX
---------#----*
------XXXXXXXXX
------XXXXXXXXX
------XXXXXXXXX
---^--XXXXXXXXX