---XXXXXXXXXXXX
---XXXXXX------
---XXXXXX------
---XXXXXX------
-----*-----^^^^
#--------------
------#----^^^^
---XXXXXX------
---XXXXXX------
---XXXXXX------
---XXXXXXXXXXXX