XXXXXXXXXXXXXXX
------XXXXXXXXX
------XXXXXXXXX
------XXXXXXXXX
^^^^----*---#XX
-------------XX
^^^^-----#----*
------XXXXXXXXX
------XXXXXXXXX
------XXXXXXXXX
XXXXXXXXXXXXXXX