-----#---^^^^^^
-----XX----X--X
X----XX----X--X
XXX--XX----X--X
-XX--XX----X--X
-XX--------X-#X
-XX--XX----X--X
#XX--XX----X--X
-XX--XX----X--X
-XX--XX--------
-XX--#---^^^^^^