^^^^^^^--XXXXXX
---------XXXXXX
----X----XXXXXX
---XX----XXXXXX
--XXX------#XXX
--X#*-------XXX
--XXX--------*-
---XX----XXXXXX
----X----XXXXXX
---------XXXXXX
^^^^^^^--XXXXXX