-------------------------
-------------------------
-------------------------
-------------------------
-------------------------
----SSSS---SS--------S---
-------------------------
-------------------------
--------------------E-EE-
------------------------X
------------------------X
------------------------X
---------------X--------X
--XXXX---XXXXXXXXX------X