-------------------------
-------------------------
-------------------------
-------------------------
-------------------------
--XX---SSSS--SSSSSSSSS---
-XXX---------------------
XXXX---------------------
XXXX---SSSS--------------
XXXX---------------------
XXXX---------------------
XXXX---------------------
XXXX---------------------
XXXXXX-----XXXX--------X-