-------------------------
-------------------------
-------------------------
-------------------------
-------------------------
S------------------------
-------------------------
-------------------------
----oo----------XSS-SQ---
XX-------Q-----XXX-------
--------------XXXX-------
-------------XXXXX-------
------------XXXXXX--SSSSS
-------XXXXXXXXXX-------X