-------------------------
-------------------------
-------------------------
-------------------------
-------------------------
-SSSSSSSS---------------S
-------------------------
E------------------------
-----------------------E-
S------------X-----------
-------------X-----------
-------------X-----------
-------------X----X------
XXXXX-----X--X--XXXXX----