-------------------------
-------------------------
-------------------------
-------------------------
-------------------------
S------------SSSSSSSSS---
-------------------------
-------------------------
----oo-------------------
XX-------Q--X------------
------------X------------
------------X------------
------------X------------
-------XXXXXXXX--------X-