-------------------------
-------------------------
-------------------------
-------------------------
-------------------------
S--------S---------------
-------------------------
-------------------------
--------E-EE-------------
--X---------XX-X------X--
--X---------XX-X------X--
--X---------XX-X----X-X--
--X---------X--X----X-X--
XXXXXX------X--X--X-X-X--