-------------------------
-------------------------
-------------------------
-------------------------
-------------------------
-----------XX------------
----------XXX------------
---------XXXX-----------<
--------XXXXX-----------[
-------XXXXXX-----------X
------XXXXXXX---E--------
-----XXXXXXXX--<>--------
---XXXXXXXXXX--[]--------
XXXXXXXXXXXXXXXXXXXXXX-XX