-------------------------
-------------------------
-------------------------
-------------------------
-------------------------
------XX-----------------
-----XXX----------------X
----XXXX---------------EX
---XXXXX--------------XXX
--XXXXXX----E--------XXXX
-XXXXXXX---<>-------XXXXX
XXXXXXXX---[]------XXXXXX
XXXXXXXX---[]--X--XXXXXXX
XXXXXXXXXXXXXXXXXXXXXXXXX