-------------------------
-------------------------
-------------------------
-------------------------
-------------------------
-------SSSSS--------XX--S
-------------------XXX---
------------------XXXX---
-----------------XXXXX---
--------S--------XXXXX---
-----E----E----XXXXXXX---
S---<>--------XXXXXXXX---
----[]-----------XXXXX---
-XXXXXXXXXXXXXXXXXXXXXXXX