-------------------------
-------------------------
-------------------------
-------------------------
-------------------------
-------------------------
-----------------E-------
----------------<>-------
----------------[]-------
----------E-----XXX------
---------<>--------------
---------[]--------------
---------[]--------------
XXXX-XXXXXXXXXXXXXXXXXXXX