-------------------------
-------------------------
-------------------------
-------------------------
-------------------------
---------XX--------------
---------XX--------------
---------XX------------XS
------XX-XX-----------XXX
-----XXX-XX---E------XXXX
----XXXX-XX--<>-----XXXXX
---XXXXX-XX--[]----XXXXXX
--XXXXXX-XX--[]--XXXXXXXX
XXXXXXX--XXXXXXXXXXXXXXX-