-------------------------
-------------------------
-------------------------
-------------------------
-------------------------
-SSSSSS---------XX-------
---------------XXX-------
E-------------XXXX-------
-------------XXXXX-------
S------------XXXXX----Q--
-----------XXXXXXX-------
----------XXXXXXXX-------
-------------XXXXX-------
XXXXX---XXXXXXXXXXXXXXXXX