-------------------------
-------------------------
-------------------------
-------------------------
-------------------------
------SS-----------------
-------------------------
-------------------------
-------------------------
------------------Q-----X
-----------------------XX
----------------------XXX
--------E--X---------XXXX
---XXXXXXXXXXXXXXXXXXXXXX