-------------------------
-------------------------
-------------------------
-------------------------
-------------------------
-------------------------
-------------------------
-----------X---XX--------
----------XX---XX--------
----------XX---XX--------
--------XXXX--XXX--------
-------XXXXX--XXX--------
----------XX--XXX--------
-XXX-XXXXXXXXXXXX--XXXXXX