-------------------------
-------------------------
-------------------------
-------------------------
-------------------------
-------------------------
-------------------------
-------------------------
---------------------S---
-------------------------
-------------------------
-------------------------
--------E----------------
----XXXXXXXXXXXXXXXXXXXXX