-------------------------
-------------------------
-------------------------
-------------------------
-------------------------
SSS--------------XXXXX---
-----------------XXXXX---
--------------XX-XXXXX---
--------------XX-XXXXX---
--------------XX-XXXXX---
--------E----XXX-XXXXX---
-------<>----XXX-XXXXX---
-------[]----XXX-XXXXX---
----XXXXXXXXXXXX-XXXXXXXX