-------------------------
-------------------------
-------------------------
-------------------------
-------------------------
-------------------------
-------------------------
-------------------------
--------X------XSS-SQ----
-------XX-----XXX--------
------XXX----XXXX--------
-----XXXX---XXXXX--------
---XXXXXX--XXXXXX--SSSSS-
XXXXXXXXXXXXXXXX-------XX