-------------------------
-------------------------
-------------------------
-------------------------
-------------------------
--------E----------------
-------<>----------------
-------[]----------------
-------[]----------------
-------XXX---------------
-------------------------
-------------------------
-------E------E-E-EE-E--E
XXXXXXXXXXXXXXXXXXXXXXXXX