-------------------------
-------------------------
-------------------------
-------------------------
-------------------------
-----------SSSSSSSSS-----
-------------------------
-------------------------
-------------------------
-------X--X--------------
------XX--X--------------
-----XXX--X--------------
---XXXXX--X--------------
XXXXXXXXXXXXX--------X-XX