-------------------------
-------------------------
-------------------------
-------------------------
-------------------------
----------SSSSSSSSS------
-------------------------
-------------------------
-------------------------
---------X---------------
---------X--------------X
---------X-------------XX
------X--X------------XXX
----XXXXXXXX--------XXXXX