-------------------------
-------------------------
-------------------------
-------------------------
-------------------------
-------------------------
-------------------------
-------------------------
-SQ----------------------
--------SS------X--------
----------------X--------
--------------X-X--------
-SSSSS--------X-X----X--E
-----XX-XXX-X-X-X--XXXXXX