-------------------------
-------------------------
-------------------------
-------------------------
-------------------------
--------------------XX---
-------------------XXX---
------------------XXXX---
-----------------XXXXX---
----------------XXXXXX---
---------------XXXXXXX---
--------------XXXXXXXX---
-------XX----XXXXXXXXX---
XXXXXXXXXXXXXXXXXXXXXXXXX