-------------------------
-------------------------
-------------------------
-------------------------
-------------------------
------XXX----------------
-----XXXX----------------
----XXXXX----------------
---XXXXXX--------oo------
--XXXXXXX-------o--------
-XXXXXXXX----------------
XXXXXXXXX----------------
XXXXXXXXX----------------
XXXXXXXXXXXXXXXXXXXXXXXXX