-------------------------
-------------------------
-------------------------
-------------------------
-------------------------
-------------------------
-------------------------
--X----------------------
--X--oo-----------o------
X-X---------X--X---------
X-X---------X--X--------X
X-X-------X-X--X--------X
X-X-------X-X--X--------X
X-X-----X-X-X--X----XXXXX