-------------------------
-------------------------
-------------------------
-------------------------
-------------------------
---S---------------------
-------------------------
-------------------------
--E-EE-------------------
------XX-XX------E-------
------XX-XX-----<>-------
------XX-XXX----[]-------
------X--XXX----[]-------
------X--XXXXXXXXXXXXXX--