-------------------------
-------------------------
-------------------------
-------------------------
-------------------------
-----SSSSSSSSSSSSSSSSSS--
-------------------------
-------------------------
-------------------------
XX-XX--------------------
XX-XX--------------------
XX-XXX-------------------
X--XXX-------------------
X--XXXXXXX--------------X