-------------------------
-------------------------
-------------------------
-------------------------
-------------------------
--------------SSSSSS-----
-------------------------
-------------------------
EE---------SSS-----------
--XX-X-----------------E-
--XX-X----------------<>-
--XX-X----------------[]-
--X--X----------------[]-
--X--X--XXXXXXX------XXXX