-------------------------
-------------------------
-------------------------
-------------------------
-------------------------
-------------------------
-------------------------
-------------------------
-SQ---------------E------
-----------------<>------
-----------------[]------
-----------------[]------
-SSSSS-----------[]------
-----XX-----XXX--XX---XXX