-------------------------
-------------------------
-------------------------
-------------------------
-------------------------
--------------S----------
-------------------------
-------------------------
-------------E-EE--------
---------X-------XX-XX---
--------XXX------XX-XX---
-------XXXX------XX-XXX--
------XXXX-------X--XXX--
----XXXXXX-------X--XXXXX