-------------------------
-------------------------
-------------------------
-------------------------
-------------------------
S------------------------
-------------------------
------------------XSS--o-
-EE--------------XXX-----
---XX-X---------XXXX-SS--
---XX-X--------XXXXX-----
---XX-X-------XXXXXX--SSS
---X--X------XXXXXXX-----
---X--X--XXXXXXXXXX------