-------------------------
-------------------------
-------------------------
-------------------------
-------------------------
-SS-----S----------------
-------------------------
----------------X--------
-------E-EE-----X--------
XXXX-------XX-X-X--------
XX---------XX-X-X--------
-----------XX-X-X--------
-----------X--X-X--------
--XX-------X--X-X--XXXXXX