-------------------------
-------------------------
-------------------------
-------------------------
-------------------------
------S---------XX-------
----------------XX-------
--------------X-XX-------
-----E-EE-----X-XX------o
---------XX-X-X-XX-------
---------XX-X-X-XX--X----
---------XX-X-X-XX--X----
---------X--X-X-XX--X----
XXX------X--X-X-XXXXX----