-------------------------
-------------------------
-------------------------
-------------------------
-------------------------
S------------S----------Q
-------------------------
---------X---------------
-EE------X--E-EE---------
---XX-XX-X------XX-X----Q
---XX-XX-X------XX-X-----
---XX-XX-X------XX-X-----
---X--XX-X------X--X-----
---X--XX-X------X--X--XXX