-------------------------
-------------------------
-------------------------
-------------------------
-------------------------
------------S------------
-------------------------
-------X------------X----
EE-----X---E-EE-----X----
--XX-X-X-------XX-X-X----
--XX-X-X-------XX-X-X---<
--XX-X-X-------XX-X-X---[
--X--X-X-------X--X-X---[
--X--X-X-------X--X-X---X