-------------------------
-------------------------
-------------------------
-------------------------
-------------------------
-----------------XX------
----------------XXX------
---------------XXXX------
--------------XXXXX------
----SS-------XXXXXX------
------------XXXXXXX------
--------<>-XXXXXXXX------
--------[]XXXXXXXXX------
--XXXXXXXXXXXXXXXXXXXXXXX