-------------------------
-------------------------
-------------------------
-------------------------
-------------------------
-------------XXXXXX------
------------XXXXXXX------
-----------XXXXXXXX------
-ooo------XXXXXXXXX------
---------XXXXXXXXXX------
--------XXXXXXXXXXX------
-------XXXXXXXXXXXX------
------XXXXXXXXXXXXX--EE--
XXXXXXXXXXXXXXXXXXXXXXXXX