-------------------------
-------------------------
-------------------------
-------------------------
-------------------------
--?SS---------------XX---
-------------------XXX---
------------------EXXX---
-----------------XXXXX---
-------ESS------XXXXXX---
---B-----------XXXXXXX---
---b----------XXXXXXXX---
---B---------XXXXXXXXX---
XXXXXXXXXXXXXXXXXXXXXXXXX