-------------------------
-------------------------
-------------------------
-------------------------
-------------------------
-------------------------
-------------------------
-------------------------
---------------X---------
--------------XX---------
-------------XXX---------
------------XXXX---------
-----------XXXXX---------
--XXXXXXXXXXXXXXXXXXXX-XX