-------------------------
-------------------------
-------------------------
-------------------------
-------------------------
-------------------------
-SS----------------------
------XX-----------------
-----XXX-----------------
----XXXX-----------------
---XXXXX-----------------
--XXXXXX-----------------
-XXXXXXX------X----------
-XXXXXX--XXXXXXXXXXXXXXXX