-------------------------
-------------------------
-------------------------
-------------------------
-------------------------
-------------------------
-------------------------
-------------------------
----------------oo-------
-------------------------
---------------------E--X
-----------------------XX
----------------------XXX
---XXXXXXXXXXXXXXXXXXXXXX