-------------------------
-------------------------
-------------------------
-------------------------
-------------------------
-------------------------
-SS----------------------
-------------------------
-----X-------------------
----XX--------E----------
---XXX-------<>----------
--XXXX-------[]----------
-XXXXX-------[]---E-E----
-XXXXXXXXXXXXXXXXXXXXXXXX