-------------------------
-------------------------
-------------------------
-------------------------
-------------------------
-------------------------
-------------------------
---------XX--------------
--------XXX--------------
-------XXXX---E---Q------
------XXXXX--<>----------
-B---XXXXXX--[]----------
-b--XXXXXXX--[]----------
XXXXXXXXXX--XXXXXXXXXXXXX