-------------------------
-------------------------
-------------------------
-------------------------
-------------------------
-----------XX---------XX-
-----------XX--------XXX-
---------X-XX-------XXXX-
---------X-XX------XXXXX-
-------X-X-XX------XXXXX-
S------X-X-XX----XXXXXXX-
-----X-X-X-XX---XXXXXXXX-
-----X-X-X-XX------XXXXX-
--XX-X-X-X-XXXXXXXXXXXXXX