-------------------------
-------------------------
--------?----------------
-------------------------
-------------------------
SS---------------XX------
----------SS----XXX------
---------------XXXX------
------SS------XXXXX------
-------------XXXXXX----E-
------------XXXXXXX---<>-
-----------XXXXXXXX---[]-
----------XXXXXXXXX---[]-
---XXXXXX-XXXXXXXXXXXXXXX