-------------------------
-------------------------
-------------------------
-------------------------
-------------------------
-------------------------
------------E------------
-----------<>------------
o-------o--[]------------
---ESS-----XX------------
-------------------E-----
--------------B----------
--------------b----------
XXXXXXX---XXXXXXXXXXXXXXX