-------------------------
-------------------------
-------------------------
-------------------------
-------------------------
-------------------------
-------------------------
-------------------------
-------------------------
-------------------------
-----X-------------------
-----X-------------------
-----X------------XX--E-E
-----XXXXXXXXXXXXXXXXXXXX