-------------------------
-------------------------
-------------------------
-------------------------
-------------------------
----------------------SSS
-------------------------
---------------------E---
-------------------------
----------E--------S?S---
---------<>--------------
---------[]--------------
---------[]--------------
---XXXXX-XXXXXXXXXXXXXXX-