-------------------------
-------------------------
-------------------------
-------------------------
-------------------------
QQS---SSSS---------------
-------------------------
-------------------------
------------------------E
SS--XX----------E------<>
----XX---------<>------[]
----XXX--------[]------[]
E---XXX--------[]------[]
XXXXXXXXX-X---XXXXXXXXXXX