-------------------------
-------------------------
-------------------------
-------------------------
-------------------------
----SSSSS---?------------
-------------------------
-------------------------
-------------------------
------------Q--------S---
-------------------------
-------------------------
------------------------E
--XXXX----XXXXXXXXXXXXXXX