-------------------------
-------------------------
-------------------------
-------------------------
-------------------------
-------------------------
-------------------------
-------------------------
-------oo----------------
---Q---------------------
-------------------------
-------------------------
---E---------------------
XXXXXX-------XXXXXXXXXXXX