-------------------------
-------------------------
-------------------------
-------------------------
---------E---------------
--------SQS--------------
-------------------------
-------------------------
-------------------------
X-------SQS--------------
-------------------------
------X------------------
------X-----E-E-----EE---
---XXXXXXXXXXXXXXXXXXXXXX