-------------------------
-------------------------
-------------------------
-------------------------
-------------------------
------------------------S
-------------------------
-------------------------
----oo-------------------
-----------------------SS
-------------------------
-------------------------
S-----------E-E-E-E------
XX-----XXXXXXXXXXXXXXXXXX