-------------------------
-------------------------
-------------------------
-------------------------
-------------------------
S-----------------E---XX-
---------------------XXX-
--------------------XXXX-
-EE---------------EXXXXX-
---XX-XX---------<>XXXXX-
---XX-XX---------[]XXXXX-
---XX-XXX-------X[]XXXXX-
---X--XXX-E----XX[]XXXXX-
---X--XXXXXXXXXXXXXXXXXXX