-------------------------
-------------------------
-------------------------
-------------------------
-------------------------
-------------------------
-------------------------
-------------------------
-----------------E-------
------E---------<>-------
-----<>---------[]-------
-----[]---------[]-------
-----[]-E------E[]-------
---XXXXXXXXXXXXXXXXXX--XX