-------------------------
-------------------------
-------------------------
-------------------------
-------------------------
-------------------------
-------------------------
-------------------------
--------------E---------E
-------------<>-------E<>
----------X--[]------<>[]
----------X--[]------[][]
----------X--[]------[][]
---X-XXX--XXXXXXXXXXXXXXX