-------------------------
-------------------------
-------------------------
-------------------------
-------------------------
-------------------------
-------------------------
-------------------------
----ooo--------XSS-SQ----
--------------XXX--------
-------------XXXX--------
------------XXXXX--------
-----------XXXXXX--SSSSS-
--XXXXXXXXXXXXXX-------XX