-------------------------
-------------------------
-------------------------
-------------------------
-------------------------
----------------SSSSSS---
-------------------------
---X---------------------
---X----------SS---------
-X-X---------------------
-X-X---------------------
-X-X---------------------
-X-X---------------------
-X-X--X-XXXXXXXXX------XX