-------------------------
-------------------------
-------------------------
-------------------------
-------------------------
-SSSSSS------QQQQ--------
-------------------------
E------------------------
------------------------E
S---------QQQ?SSQQQ----<>
-----------------------[]
----------E------------[]
-----------------------[]
XXX-----XXXXXX--XXXXXXXXX