-------------------------
-------------------------
-------------------------
-------------------------
-------------------------
-------------------------
-------------------------
-------------------------
-------------------------
X----------------------E<
--------------------XX<>[
-------------------XXX[][
--------------X---XXXX[][
--------XXXXXXXXXXXXX-XXX