-------------------------
-------------------------
-------------------------
-------------------------
-------------------------
-------------------------
-------------------------
-------------------------
----oo-------------------
-------------------<>----
-------------------[]----
-------------------[]---<
--------------E----[]---[
--------XXX-XXXXXXXXXXXXX