-------------------------
-------------------------
-------------------------
-------------------------
-------------------------
--------------SSSS-------
-------------------------
-------------------------
---XSS-SQ-----SSSS-------
--XXX--------------------
-XXXX-------------------X
XXXXX-------------------X
XXXXX--SSSSS------------X
XXXX-------XX-----XXXXXXX