-------------------------
-------------------------
-------------------------
-------------------------
-------------------------
-------------------------
-------------------------
-----------------------oo
----oo-------------------
-X-----------------XXX---
-X-----------------XXX---
-X---------E-------XXX---
-X-----------------XXX---
-X-----XXX-X-XXXXXXXX---X