#######-#------------#---
--#####-#------------#---
--#####-#------------#---
----###-----------T------
#-----------------T------
#-----------#-----T------
#-#---------#-#---T------
#-#---------#-#DDDD------
#-#---------#-#----------
#-#-------#H--#--------#H
#-#-------#H-----------#H
#-#-------#H-----------#H
###-----#DD#---------#DD#
###-----#------------#---
#######-#------------#---
#######-#------------#---