---#--------###-#########
---#---########-#DDDDDDDD
---#---######-#-#--------
---#---#####--###--------
-------#####---##--------
-------#-------##--------
-#---#-H-------##--------
-#---#-----H----#--------
-#-###-----#----#--------
-#-###-----#----#--------
---#-------#-------------
---#---#####-------------
---#---#####--##---------
---#---#####--##---------
---#---#########---------
---#--------#############