#####---###---##-----####
--###---########-----####
--##############-----####
-----#########-#---T-####
#----####--###-----T-#---
#----####--#-------T-#---
#-#---#----H-----#-T-----
#-#---#--H---H---#DD--H--
#-#---#--#---#---#----#--
#-#---H--#---#---#----#--
#-#------#---#--------#--
#-#---H--#-###--------#--
###--#####-###-------##--
###--#####-###-------##--
##########D#####-----##DD
###########---##-----####