--###---#---####---##-#--
--#######---#########-M--
--###################-M--
--######-##########-#-M--
--#--###-####---###---M--
--#--#---####---#-----M--
-----H----#-----H-----MH-
---H---H--#--H----H---M--
#--#---#--#--#----#---M--
#--#---#--H--#----#---M--
#--#---#-----#----#---M--
#--#-###--H--#--###---M--
#-##-###-#####--###---MH-
#-##-###-#####--###---M--
#-############Dd#####-M--
#-###---########---##-M--