------####---##-#------#-
------#########-M---####-
###############-M---#####
#############-#-M---###-#
#######---###---M---###-#
#######---#-----M---#---#
#-#-#-----H-----M---H----
#-#-#--H----H---M-T---H--
#-#-#--#----#---M-T---#--
H-H-H--#----#---M-T---#--
-------#----#---M-T---#--
H-H-H--#--###---M---###--
########--###---M---###-#
########--###---M---###-#
########Dd#####-M---#####
##########---##-#------##