#-M-M------#####---#--M--
H-M-M---########---M--M--
H-M-M---####---T---M--MH-
H-#-M---###------T-M--M--
#-M-M---###------T-M--M--
--M-M---#--------T-M--M--
--M-M---H--------T-MH-M--
#-M-M-----H--#-----M--M--
H-M-MH----#--#-----M--M--
H-M-M-----#--#---T-M--M--
H-M-M-----#--#---T-M--M--
H-M-M---###--T---T-M--MH-
H-M-MH--###--T---T-MH-M--
H-M-M---###--T-----M--M--
#-M-M---######Dd---M--M--
#-M-M------#####---M--M--