###---###########----####
#D#----##########-#######
#------##########-####-#-
#---T--#DDDDDDD##-###--#-
----T--#----------###--#-
----T--#----------#----#-
----T--#----------H----#-
-------#------------H--#-
-------#------------#--#-
----T---------------#--#-
----T----------T----#----
----T--T----------###----
--#-T----------##-###----
D-#------------##-###----
--#------------##-#######
###---###########----####