######---##-------#####--
--#########-------#######
--#########-------#######
----#####-#-----T-#######
#-----###-------T-#----##
#-----#---------T-#----#-
#-#---H-----#---T------H-
#-#-----H---#DDDD--H-----
#-#-----#---#------#-----
#-#-----#---#------#-----
#-#-----#----------#-----
#-#---###----------#---##
###---###---------##---##
###---###---------##---##
###########-------##DDD##
######---##-------#####--