------####---##-M---####-
------#########-M---#####
###############-MH--#####
#############-#-M---#####
#######---###---M---#---#
#######---#-----M---#---#
#-#-#-----H-----###-----H
#-#-#--H----H---M----H---
#-#-#--#----#---M----#---
H-H-H--#----#---M----#---
-------#----#---MH---#---
H-H-H--#--###---M----#--#
########--###---M---##--#
########--###---M---##--#
########Dd#####-M---##Dd#
##########---##-M---####-