####-#--#--#--#----#--#--
--##-M--M--M--M----M--M--
-----M--M--M--M----M--M--
-----M--M--M--M----M--M--
#----M--M--M--M----M--M--
#----M--M--M--M----M--M--
#----MH-MH-MH-MH---MH-MH-
#----M--M--M--M----M--M--
#----M--M--M--M----M--M--
#----M--M--M--M----M--M--
#----M--M--M--M----M--M--
#----M--M--M--M----M--M--
###--MH-MH-MH-MH---MH-MH-
###--M--M--M--M----M--M--
###--M--M--M--M--T-M--M--
####-M--M--M--M----M--M--