#-M-M--M---#--M-####---#-
H-M-M--M---M--M-########-
H-M-M--MH--M--M-#########
H-#-M--M---M--M-#######-#
#-M-M--M---M--M-#---###-#
--M-M--M---M--M-#---#---#
--M-M--###-MH-M-----H----
#-M-M--M---M--M--H----H--
H-M-MH-M---M--M--#----#--
H-M-M--M---M--M--#----#--
H-M-M--MH--M--M--#----#--
H-M-M--M---M--M--#--###--
H-M-MH-M---MH-M-##--###-#
H-M-M--M---M--M-##--###-#
#-M-M--M---M--M-##Dd#####
#-M-M--M---M--M-####---##