----####---##-M-#--#-----
----#########-M-M--M--###
#############-M-M--M--###
###########-#-M-M--M--###
#####---###---M-M--M--###
#####---#-----M-M--M--#--
#-#-----H-----M-MH-MH-H--
#-#--H----H---#-M--M----H
#-#--#----#---M-M--M----#
H-H--#----#---M-M--M----#
-----#----#---M-M--M----#
H-H--#--###---M-M--M--###
######--###---M-MH-MH-###
######--###---M-M--M--###
######Dd#####-M-M--M--###
########---##-M-M--M-----