##########--------####---
---#######--------#######
T----#--#---------#######
--#--#--#-------T-#######
--#--#--#-------T-#---###
###-------------T-#---#--
###---------#---T-----H--
###---------#DDDD--H----H
###DD-------#------#----#
---#######--#------#----#
---#######---------#----#
--T-H--H-----------#--###
--T---------------##--###
-----T--T---------##--###
#----T--T---------##DD###
##########--------####---