------####---##-#--#-----
------#########-M--M--###
###############-M--M--###
#############-#-M--M--###
#######---###---M--M--###
#######---#-----M--M--#--
#-#-#-----H-----MH-MH-H--
#-#-#--H----H---M--M----H
#-#-#--#----#---M--M----#
H-H-H--#----#---M--M----#
-------#----#---M--M----#
H-H-H--#--###---M--M--###
########--###---MH-MH-###
########--###---M--M--###
########Dd#####-M--M--###
##########---##-M--M-----