##-M--M-M--#---#------##-
##-M--M-M--M---#------##-
-T-M--M-M--M---#------M--
---M--M-M--M----------M--
---M--M-MH-M----------M--
---M--M-M--M-------#--M--
---M--M-M--MH------#--M--
---M--#-M--M-------#--M--
---MH-M-M--M-------#--M--
---M--M-M--M-----#H---M--
---M--M-M--M-----#H---M--
---M--M-M--M-----#H---M--
---MH-M-M--MH--#DD#---M--
---M--M-MH-M---#------M--
DD-M--M-M--M---#-----#M--
##-M--M-M--M---#-----###-