##########-#--------#--#-
--########-M--------M--M-
--##-----T-M--------M--M-
-----------M------T-M--M-
#----------M------T-M--M-
#----------M------T-M--M-
#-#--------MH-#---T-MH-MH
#-#--#-----M--#DDDD-M--M-
#-#--#-----M--#-----M--M-
#-#--#-----M--#-----M--M-
#-#--#-----M--------M--M-
#-#--T-----M--------M--M-
###--T-----MH-------MH-MH
###--T-----M--------M--M-
######DDDD-M--------M--M-
##########-M--------M--M-