####-#----#--#--#-------#
####-M----M--M--M-------#
#--T-M----M--M--M-------M
#----M----M--M--M----T--M
-----M----M--M--M----T--M
-----M----M--M--M----T--M
-----MH-#-MH-MH-MH-#-T--M
-----M--#-M--M--M--#DD--M
-----M--#-M--M--M--#----M
-----M--#-M--M--M--#----M
-----M----M--M--M-------M
#----M----M--M--M-------M
#----MH---MH-MH-MH------M
#----M----M--M--M-------M
#DDD-M----M--M--M------#M
####-M----M--M--M------##