####-#--------######-####
####-M--------######--###
--#--M-------------T--###
--#--M------T---------#DD
--#--M------T---------#--
-----M------T---------#--
-----MH-#---T---------#--
-----M--#DDDD--#------#--
DD---M--#------#------#--
####-M--#------#---------
####-M---------#---------
-H---M---------T------T--
-----MH--------T---------
--T--M---------T---------
--T--M--------##DDDD-----
####-M--------######-####