#####-###---##-#####---##
#####-########-##########
----T-########-##########
------######-#-########-#
------#--###---#----###--
------#--#-----#----#----
---------H----------H----
-------H---H----H-----H--
-------#---#----#-----#--
-------#---#----#-----#--
-------#---#----#-----#--
-------#-###----#---###--
------##-###---##---###--
------##-###---##---###--
DDDDD-##D#####-##DDD#####
#####-###---##-#####---##