-M-M--M--#--#--M--M-M--M-
-M-M--M--M--M--M--M-M--M-
-M-M--M--M--M--MH-M-M--MH
-#-M--M--M--M--M--M-M--M-
-M-M--M--M--M--M--M-M--M-
-M-M--M--M--M--M--M-M--M-
-M-M--M--MH-MH-M--M-M--M-
-M-M--M--M--M--M--#-M--M-
-M-MH-MH-M--M--M--M-MH-M-
-M-M--M--M--M--M--M-M--M-
-M-M--M--M--M--M--M-M--M-
-M-M--M--M--M--MH-M-M--MH
-M-MH-MH-MH-MH-M--M-MH-M-
-M-M--M--M--M--M--M-M--M-
-M-M--M--M--M--M--M-M--M-
-M-M--M--M--M--M--M-M--M-