--M-M--M-M--#--M--M-M--M-
--M-M--M-M--M--M--M-M--M-
H-M-M--M-M--M--MH-M-MH-MH
--M-M--M-M--M--M--M-M--M-
--M-M--M-MH-M--M--M-M--M-
--M-M--M-M--M--M--M-M--M-
--M-M--M-M--MH-M--M-M--M-
--M-M--#-M--M--M--#-M--M-
--M-MH-M-M--M--M--M-M--M-
--M-M--M-M--M--M--M-M--M-
--M-M--M-M--M--M--M-M--M-
H-M-M--M-M--M--MH-M-MH-MH
--M-MH-M-M--MH-M--M-M--M-
--M-M--M-MH-M--M--M-M--M-
--M-M--M-M--M--M--M-M--M-
--M-M--M-M--M--M--M-M--M-