--T-###-----T############
--T-#D#-----T#DDDDDDDDDDD
--T-#-------T#-----------
--T-#-----T-T#-----------
--T#------T-T#-----------
--T#------T-T#-----------
---#----#-T-T#-----------
---#----#DD-T#-----------
--T-----#----#-----------
--T-----#----#-----------
--T----------------------
--T----------------------
--T----------------------
--TDD--------------------
--T----------------------
--T####------############