####-#--------#-------#--
####-M--------M-------#--
--#--M--------M-------#--
--#--M------T-M-----T----
--#--M------T-M-----T----
-----M------T-M-----T----
-----MH-#---T-MH-#--T----
-----M--#DDDD-M--#DDD----
DD---M--#-----M--#-------
####-M--#-----M--#------#
####-M--------M---------#
-H---M--------M---------#
-----MH-------MH------#DD
--T--M--------M-------#--
--T--M--------M-------#--
####-M--------M-------#--