########-T-########-#####
----####-T-#DDDDDD#-#####
-T----#--T-#--------#####
---#--#--T-#--------#####
---#--#--T#---------#----
####-----T#---------#----
####------#--------------
####------#----------H---
####DD---T-----------#---
----####-T-----------#---
----####-T-----------#---
---T-H---T-----------#---
---T-----T----------##---
H-----T--TDD--------##---
##----T--T----------##DDD
########-T#########-#####