##-M---###T-T############
##-M---M#-T-T#DDDDDDDDDDD
-T-M---MH-T-T#-----------
---M---M--T-T#-----------
---M---M----T#-----------
---M---M----T#-----------
---M---M----T#-----------
---M---M----T#-----------
---MH--M-----#-----------
---M---M-----#-----------
---M---M-----------------
---M---M-----------------
---MH--M-----------------
---M---M-----------------
DD-M---MH----------------
##-M---####--############