-####-#-----#---########-
-#DD#-M--####---#########
-#----M--################
-#----M--###-############
#-----M--###-####-------#
#-----M--#---####-------#
#-----MH-H----#---------H
#-----M----H--#--H-------
------M----#--#--#-------
------M----#--H--#-------
------M----#-----#-------
------M--###--H--#------#
----#-MH-###-#####------#
DD--#-M--###-#####------#
----#-M--#########DDDDDD#
#####-M-----############-