-###-#--------#--------#-
-#D#-M--------M--------M-
-#---M--------M--------M-
-#---M------T-M------T-M-
#----M------T-M------T-M-
#----M------T-M------T-M-
#----MH-#---T-MH-#---T-MH
#----M--#DDDD-M--#DDDD-M-
-----M--#-----M--#-----M-
-----M--#-----M--#-----M-
-----M--------M--------M-
-----M--------M--------M-
-----MH-------MH-------MH
DD---M--------M--------M-
-----M--------M--------M-
####-M--------M--------M-