-###############-#--M--M-
-#DDDDDDDDDDDDD#-M--M--M-
-#---------------M--M--MH
-#---------------M--M--M-
#----------------M--M--M-
#----------------M--M--M-
#----------------MH-M--M-
#----------------M--M--M-
-----------------M--MH-M-
-----------------M--M--M-
-----------------M--M--M-
-----------------M--M--MH
-----------------MH-MH-M-
DD---------------M--M--M-
-----------------M--M--M-
################-M--M--M-