#####---####-#T-T####----
--##########--T-T####----
--##########--T-T####----
----####-###--T-T####----
#----###--------T##---#--
#----#----------T#-------
#-#--H----------T#-------
#-#----H--------T#-------
#-#----#--------T#--#----
#-#----#--------T---#----
#-#----#------------#--#-
#-#--###------------#----
###--###------------#----
###--###------------#----
############--------#----
#####---####-##-----#----