------------#------------
---------T--M------------
---------T--M------------
---------T--M------------
-#-------T--M------------
------------M----------T-
------------MH-------T---
-------T----M--------T---
-#-----T----M--------T---
---T---T----M--------T---
---T---T----M--------T---
---T--------M------------
---T--------MH-----------
------------M------------
------------M------------
------------M------------