####-----M---M-----------
--##-----M---M------#--T-
---------M---M-----------
---------M---M-----------
#--------M---M-#---------
#--------M---M-----------
#--------M-#-M----#------
#--------#---#-----------
#--------M---M-#---------
#--------M---M-----------
#--------M---M-----------
#------#-M---M-----------
####-#---M---M-----------
####-----M---M-----------
####-----M---M-----------
####-----M---M-----------