#####---##-#-------------
--########-M--------#--T-
--########-M-------------
----####-#-M-------------
#----###---M-------------
#----#-----M-------------
#-#--H-----M-#----#------
#-#----H---M-------------
#-#----#---M-------------
#-#----#---M-------------
#-#----#---M-------------
#-#--###---M---#---------
###--###---M-------------
###--###---M-------------
##########-M-------------
#####---##-#-------------