########T#####T----------
##DD###-T-----T----------
##---##-T-----T----------
##---##-T-----T----------
-#---##------------#####-
-#---##------------#####-
-#---##------------#####-
-#---##---#--------#####-
-----#----#--------#-----
-----#----#--------#-----
-----#----#--------------
-----##---#--------------
#######---#-----T--------
#######---#-----T--------
#######D###-----T--------
###############-T--------