#######-#-----########-##
--#####-#-----##---###-##
--#####-#-----#----######
----###-------#-------###
#-------------#--#----##-
#-----------#-#-##----##-
#-#---------#---##-#-----
#-#---------#---##-#----H
#-#---------#---##-#----#
#-#-------#H----##-#----#
#-#-------#H----##-#----#
#-#-------#H----##-#----#
###-----#DD#--######--###
###-----#-----######--###
#######-#-----###########
#######-#-----###########