#-######----#############
#-######-################
--######-####-###########
--##Dd##-###--######Dd###
---#-----###---#---#-----
---#-----#-----#---#-----
---#-----H-----#---#-----
---#-------H---#---#-----
-----------#---#---------
-----------#---#---------
------T----#-----T----T--
------T--###-----T----T--
--####T#-###--###T####T##
--####T#-###--###T####T##
--######-################
#-######----#############