-M-M--------#------------
-M-M--------M------------
-M-M------#-M------------
-#-M--------M-------#----
-M-M--------M-------#-T--
-M-M--------M-------#-T--
-M-M---T----MH------#-T--
-M-M---T----M---------T--
-M-MH--T----M---------T--
-M-M---T----M---------T--
-M-M--------M---------T--
-M-M--------M------------
-M-MH-------MH-----------
-M-M--------M------------
-M-M--------M------------
-M-M--------M------------