----##-----M---------#--#
----##-----M---------M--M
----M------M-------#-M--M
----M------M---------M--M
----M------M---------M--M
----M------M---------M--M
----M------M---#-----MH-M
#---M------#---------M--M
----M------M---------M--M
----M------M---------M--M
----M------M---------M--M
----M------M---------M--M
##--M--##--M---------MH-M
##--M------M---------M--M
##-#M------M---------M--M
##-###-----M---------M--M