--M---------#---M--------
#-M---#-----M---M--------
#-M---#-----M---MH-------
#-M---#-#---M---M--------
#-M---#-#---M---M--------
--M---#-#---M---M--------
--M---#-#---MH--####-----
--M---#-----M---M-----T--
--M---#-----M---M-----T--
--M---------M---M-----T--
--M---------M---MH-------
--M--#------M---M--------
--M--#------MH--M---#----
--M--#------M---M--------
--M--#------M---M--------
--M---------M---M--------