----######-----M---T--M--
-----T-------#-M---T--M--
-----T-------#-M---T--MH-
-------------#-M---T--M--
-##----------#-M---T--M--
-##--------#H--M---T--M--
-##--------#H--M---T--M--
-##--------#H--M---T--M--
-#-------#H##--M------M--
-#-------#H----M------M--
---------#H----M------M--
---------##----M------MH-
---------#-----M------M--
---------#-----M------M--
---------#-----M------M--
---------#-----#------M--