#####---#-------#--#--#--
--###---#-------M--M--M--
--###---#-------M--M--M--
----#---#-------M--M--M--
#----#--------#-M--M--M--
#---------------M--M--M--
#-#-------##----MH-MH-MH-
#-#-------------M--M--M--
#-#-----#-----#-M--M--M--
#-#-----#-------M--M--M--
#-#---#-#-------M--M--M--
#-#-----#-------M--M--M--
###-----#-------MH-MH-MH-
###-----#-------M--M--M--
#####---#-------M--M--M--
#####---#-------M--M--M--