#---T########---#--M-####
#---T#Dd#####---M--M-###D
----T#---##-T---M--M-###-
----T#---##---T-M--M-###-
----T#---#----T-M--M---#-
----T#---#----T-M--M---#-
----T#---#----T-MH-M---#-
----T#---#------M--M---#-
-----#---#------M--M-----
--#--#---#----T-M--M-----
--#------#----T-M--M-----
###------##---T-M--M-----
###-----###---T-MH-M-####
#-------###-----M--M-####
#-------###Dd---M--M-####
#----########---M--M-####