--M------#------M--------
--M------M------M--------
--M------M----#-M--------
--M------M------M--------
--M------M------M-----#--
--M------M------M--------
--M---##-MH-----M--------
--M------M------M--------
--MH-----M--T---MH----#--
--M------M--T---M--------
--M------M--T---M--------
--M------M--T---M--------
--MH-----MH-----###------
--M------M------M--------
--M------M------MH-------
--M------M------M--------