#####------M--M-----#--#-
--###------M--M-----M--M-
----#------M--M---#-M--M-
----#------M--M-----M--M-
#----------M--M-----M--M-
#----------M--M-----M--M-
#----------M--M-----MH-MH
#----------#--#-----M--M-
#----------M--M-----M--M-
#----------M--M-----M--M-
#----------M--M-----M--M-
#----------M--M-----M--M-
###-#-#-#--M--M-----MH-MH
###-#------M--M-----M--M-
#####------M--M-----M--M-
#####------M--M-----M--M-