--M---T----M--#-------###
--M---T----M--M----------
--M---T----M--M------T--T
--M---T-T--M--M---T--T---
--M-----T--MH-M----------
--M-----T--M--M--T-------
--M--------M--MH-T-------
--M--------M--M----------
--MH-----T-M--M----######
--M------T-M--M-------###
--M------T-M--M--T----T--
--M------T-M--M--T--T----
--###-#----M--MH----T---T
--M---#----MH-M---------T
--MH--#----M--M---------#
--M---#----M--M---------#