------######T-#----------
------M#-M#-T-M----------
------MH-MH-T-M----------
------M--M--T-M--------T-
---T--M--M----M--T---T-T-
---T--M--M----M--T---T-T-
---T--M--M----MH-T-T-TD--
---T--M--M----M--T-T-T---
------M--M----M----T----T
------M--M----M----T----T
------M--M----M----T----T
------M--M----M----T----T
-T----M--M----MH---T-----
-T----M--M----M----T-----
-T----MH-MH---M----------
-T----#######-M----------