#####---#-##---M-#--#--#-
--###---#-#----M-M--M--M-
--###---#-#----M-M--M--M-
----#---#-#----M-M--M--M-
#----#----#----M-M--M--M-
#---------#-T#-M-M--M--M-
#-#-------#-T#-M-MH-MH-MH
#-#-------#-T#-#-M--M--M-
#-#-----###-T#-M-M--M--M-
#-#-----###----M-M--M--M-
#-#---#-#------M-M--M--M-
#-#-----#------M-M--M--M-
###-----#------M-MH-MH-MH
###-----#------M-M--M--M-
#####---#------M-M--M--M-
#####---#------M-M--M--M-