-#-##########T###########
-#-#######---T---M#-#####
##-#######---T---MH-#####
##-----###---T---M--#DD##
------####---T---M--#----
------####---T---M--#----
------####-------M--#----
------####-----#-M--#----
------###------#-M--#----
-------##------#-M-------
-------##------#-M-----T-
-------###-----#-M--T----
---T--####-----#-M-----##
------####-----#-M-----##
------####DDD###-MH----##
---######################