#-----##########-###-####
##########D###-#-----##DD
#######-##--##-------##--
######--##--##-------##--
-#####---#--##-------###-
-#-------#--##-------##--
-H-------#--##-------##--
-----H---#--##-------##--
-----#------#-----##-###-
-----#------#-----#--##--
-----#------#-----#--##--
-#####------##----#--##--
-#####--######-#--#-##---
-#####--######-#--#------
D#############D#--#-#----
#-----##########--#######