#######-#-----###-#------
--#####-#-----###-M------
--#####-#-----###-M------
----###-------###-M------
#-----------------M------
#-----------#-----M------
#-#---------#-----MH-#---
#-#---------#-----M--#DDD
#-#---------#-----M--#---
#-#-------#H---#--M--#---
#-#-------#H---#--M------
#-#-------#H---#--M------
###-----#DD#--###-MH-----
###-----#-----###-M------
#######-#-----###-M------
#######-#-----###-M------