#####-#-----M--M----###--
#####-M-----M--M-########
#####-M-----M--M-########
#Dd##-M-----M--M-###-####
#-----M-----M--M-###---##
#-----M-----M--M-#-----#-
#-----M---T-M--M-H-----H-
#-----M---T-M--#---H-----
------M---T-MH-M---#-----
------M---T-M--M---#-----
---T--M---T-M--M---#-----
---T--M---T-M--M-###---##
###T#-M---T-MH-M-###---##
###T#-M---T-M--M-###---##
#####-M-----M--M-########
#####-#-----M--M----###--