#######-#-----#---M-#####
--#####-#-----#---M-#####
--#####-#-----#---M-#####
----###-------#---M-#####
#-----------------M-#----
#-----------#-----M-#----
#-#---------#---#-M------
#-#---------#---#-#--H---
#-#---------#-###-M--#---
#-#-------#H--###-M--#---
#-#-------#H--#---M--#---
#-#-------#H--#---M--#---
###-----#DD#--#---M-##---
###-----#-----#---M-##---
#######-#-----#---M-##DDD
#######-#-----#---M-#####