#####---####---#--#--#--M
--##########---M--M--M--M
--##########---M--M--M--M
----####-###---M--M--M--M
#----###-------M--M--M--M
#----#---------M--M--M--M
#-#--H---------MH-MH-MH-M
#-#----H-------M--M--M--M
#-#----#-------M--M--M--M
#-#----#-----#-M--M--M--M
#-#----#-----#-M--M--M--M
#-#--###-----#-M--M--M--M
###--###-----#-MH-MH-MH-#
###--###-----#-M--M--M--M
############-#-M--M--M--M
#####---####-#-M--M--M--M