XXXXXXXXXXXXXXX
XXXXXXXXXXXXXXX
XXXXXXXXXXXXXXX
XXXXXXXXXXXXXXX
XXXXXXXXXXXXXXX
XXXXXXXXXXXXXXX
XXXX------XXXXX
-XXX---------XX
-XXXXXXXXX-----
----XXXXXXXXX--
XXXXXXXXXXXXXXX