----#---X----XX
\\--XX--X------
//--XX--X----XX
----XX--X------
----XX--X----XX
--------X-----&
----XX--X----XX
----XX--X------
&---XX--X----XX
----XX--X------
----#---&----XX