^X^^^XXXXXXXXXX
-X---XXXXXXXXXX
-X--XXXXXXXXXXX
-X-XXXXXXXXXXXX
&XXXX-------#XX
XXX#*X-------XX
*XXXXX---#----*
-X-XXXXXXXXXXXX
-*--XXXXXXXXXXX
-----XXXXXXXXXX
^#^^^XXXXXXXXXX