^^^^XXXXXXXXXXX
----XXXXXXXXXXX
-X--XXXXXXXXXXX
XXX-XXXXXXXXXXX
XXXX*----*-----
#*#X--#------#-
XXXX------#----
XXX-XXXXXXXXXXX
-X--XXXXXXXXXXX
----XXXXXXXXXXX
^^^^XXXXXXXXXXX