----XXXXXXXXXXX
--^-^^^^^^^^^^^
----^^^^^^^^^^^
--^-^^^^^^^^^^^
----^^---^^^---
--^-&-----&----
----^^---^^^---
--^-^^^^^^^^^^^
----^^^^^^^^^^^
--^-^^^^^^^^^^^
----XXXXXXXXXXX