-XXXXXXX^^^^^^^
-XXXXXXX-X--X--
-XXXXXXX-X--X--
-XXXXXXX-X--X--
---*-----X--X--
--------#X-#X-#
----#----X--X--
-XXXXXXX-X--X--
-XXXXXXX-X--X--
-XXXXXXX-------
-XXXXXXX^^^^^^^