XX^X^^^^X^XXXXX
XX-X----X-XXXXX
XX-X---XXXXXXXX
XXXXXXXXXXXXXXX
XXXXX*XXXX--#XX
XX#-X&-X-X---XX
XXXXX*XXXX----*
XXXXXXXXXXXXXXX
X*-X/\\XXXXXXXX
---X\//*XXXXXXX
-#^X^^^^X^XXXXX