^^^^^^XXXXXXXXX
------XXXXXXXXX
------XXXXXXXXX
----X-XXXXXXXXX
&-&-X---*---#XX
XXXXX--------XX
*#*-X----#----*
----X-XXXXXXXXX
------XXXXXXXXX
------XXXXXXXXX
^^^^^^XXXXXXXXX