X--^^^^^^^^^^^^
-------*----*--
---------------
------^^^--^^^-
---^^^^^^^^^^^^
-------&----&--
---^^^^^^^^^^^^
------^^^--^^^-
---------------
-------*----*--
X--^^^^^^^^^^^^