^^^^XXXXXXXXXXX
----XXXXXXXXXXX
-X--XXXXXXXXXXX
XXX-XXXXXXXXXXX
XXX-#XXXX--*-XX
#*#--XXXX----XX
XXX---*-----#XX
XXXXXXXXXXXXXXX
-X-XXXXXXXXXX*X
---#XXXXXXXXX--
^^^^XXXXXXXXX#-