^^^^XXX^^^XXXXX
----XXX---XXXXX
-XX-XXX-X-XXXXX
XXX-XXX-X-XXXXX
XXX-#XX-X-XXX--
#*X--XX#X-XX---
XXX---*-X------
XXXXXXX-X-XXXXX
-XXXXXX-X-XXXXX
--*#XXX-X-XXXXX
^^^^XXX^^^XXXXX