^X^^^^XXXXXXXXX
-X----XXXXXXXXX
-X--X-XXXXXXXXX
-XXXX-XXXXXXXXX
&XXXX---*---#XX
XX##*--------XX
*XXXX----#----*
-XXXX-XXXXXXXXX
-*--X-XXXXXXXXX
------XXXXXXXXX
^#^^^^XXXXXXXXX