XX^^^^^^^XXXXXX
XX-------XXXXXX
XX--X--X-XXXXXX
XX-XX--X-XXXXXX
XXXXX--X----#XX
XXX#*--X-----XX
XXXXX--X-#----*
-X-XX--XXXXXXXX
&*--X--XXXXXXXX
X------*#XXXXXX
X#^^^^^^^XXXXXX