XX^X^^^^X^^^^XX
XX-X----X-*#XXX
XX-X---XX-XXX-X
XX-XXXXXX-XX---
-X&XX*XXX-X---X
XXX-X&-X--X----
XX*XX*XXX-X---X
XX-XXXXXX-X----
X*-X/\\XX-X---X
X--X\//*X----XX
X#^X^^^^X^^^^XX