-----^^^^^^^^^^
--------------^
^--^----X-----^
^--^---XX-----^
^--^X-XXX------
^--^X-X#*-----^
#-#-X-XXX------
-------XX--X--^
--------X--X--^
XXXX-------X--^
XXXX-^^^^^^^^^^