XXX--^^^^^^^^^^
XXX------------
XXX----X-----X-
XXX----X-----XX
X------X-----XX
X------X-----*#
**-----X-----XX
XXX----XX----XX
XXX----XXX---X-
XXX----*#X-----
XXX--^^^^^^^^^^