^^^^^^^^^^^^^^^
------^^^------
---------------
-----------X---
--^^-------X-&-
-----------XXXX
--^^-------X-*#
-----------X---
---------------
------^^^------
^^^^^^^^^^^^^^^