^^^^^^^^^^^^^^^
---------------
-------------X-
---X----XXX--XX
---X^---X*X--XX
XXXX^^--X&---*#
---X^---X*X--XX
---X----XXX--XX
---//\\//\\--X-
---\\//\\//----
^^^^^^^^^^^^^^^