^^^^^^^^^^^^^^^
------*--------
---------------
-----^^^-------
---^^^^^^^-&-&-
------&---XXXXX
---^^^^^^^-*#*-
-----^^^-------
---------------
------*--------
^^^^^^^^^^^^^^^