^^^^X^^^XXXXXXX
----X---XXXXXXX
-XX-XXX-XXXXXXX
XXX-XXX-XXXXXXX
XXX-#XX-X*-----
#*X--X*-X----#-
XXX--XX-X-#----
XXXXXXXXXXXXXXX
-XXXXXXX*XXXXXX
--*#XX-#-XXXXXX
^^^^X^^^#XXXXXX