^X^^^^X^X^^XXXX
-X----X-X#*XXXX
-X--X-XXXXXXXXX
-XXXX-XXXXXXXXX
&XXXX--X*XX-#XX
XX##*-XX-XX--XX
*XXXX-XX-XX---*
-XXXX-XXXXXXXXX
-*--X-XXXXXXXXX
------X*XX-XXXX
^#^^^^X^X^^XXXX