XX^^^^^^^^^^^^^
XX-------------
XX--X--X-----X-
XX-XX--X-----XX
XXXXX--X-----XX
XXX#*--X-----*#
XXXXX--X-----XX
-X-XX--XX----XX
&*--X--XXX---X-
X------*#X-----
X#^^^^^^^^^^^^^