^^^^^^^^^^^XXXX
-----------XXXX
-XX--XX-X--XXXX
XXX--XX-X--XXXX
XXX--XX-X--*---
#*X-#XX-X-#--#-
XXX--XX-X------
XXXX-XXXX--XXXX
-XXX-XXXX--XXXX
--*#-X*#X--XXXX
^^^^^^^^^^^XXXX