^^^XX^^^^^^^^XX
---XX----X--XXX
-XXXXXX--X--XXX
XXXXXXXX-X--XXX
XXX-#XXX-X--XXX
#*X#-X*##X-#XXX
XXX--XXX-X--XXX
XXXXXXXX-X--XXX
-XXXXXX--X--X*X
--*XXX---------
^^^XX^^^^^^^^#-