-XXX^^^^^^^^^^^
-XXX------*#---
^X-----X--XX-X-
^X----XX--XX-XX
^XXX-XXX--X--XX
^XXX#X#*--X-#*#
#*XX-XXX--X--XX
-XXX--XX--X--XX
-XXX---X--X--X-
XXXX-----------
XXXX^^^^^^^^^^^