-------------XX
--------XXX--XX
---------&---XX
--------XXX--XX
---#-----------
--------XXX----
---------------
-----*--XXX--XX
&--------&---XX
--------XXX--XX
-------------XX