---------XXXXXX
------#--XXXXXX
---------XXXXXX
-//\\----XXXXXX
-\\//-*--XXXXXX
XXXXXXXXXXXXXXX
-----------XXXX
---------------
-------XXXX----
-------XXXXXXXX
-------XXXXXXXX