^^^XX^^^^^^^^^^
---XX-----*#---
---XX--X--XX-X-
XXXXX-XX--XX-XX
X*XX-XXX--X--XX
X&-X-X#*--X-#*#
X*X**XXX--X--XX
XXXXX-XX--X--XX
/\\XX--X--X--X-
\//XX----------
^^^XX^^^^^^^^^^