XX---------XXXX
XX---------XXXX
XX---XX----XXXX
XX-#-XXXX--XXXX
XX-----XX------
XXXX---XX----#-
XXXX---XX------
XXXX--#XX--XXXX
XXXX---XX--XXXX
-------XX--XXXX
&------XX--XXXX