--XXXXXXXXXXXXX
--XXXXXXXXXXX--
--XXXXXXXXXXX--
X-XXXXXXXXXXX--
X-------*------
X-XXXX---------
X-XXXX---#-----
X-XXXXXXXXXXX--
X-XXXXXXXXXXX--
X-XXXXXXXXXXX*#
X-XXXXXXXXXXXXX