XXXXXXXXXXXXXXX
XXXXXXXXXXXXXXX
XXXXXXXXXXXXXXX
XXXXXXXXXXXXXXX
XXXXXXXXXXXX-XX
--XXXXXXXXXX-XX
XXXXX-*-----#XX
XX---XXXXXXXXXX
XX---XXXXXXXX*X
XXXXXXXXXXXXX--
XXXXXXXXXXXXX#-