-------XXXXXXXX
-------XXXXXX--
-------XXXXXX--
-------XXXXXX--
---------------
---------------
---------#-----
#------XXXXXX--
-------XXXXXX--
-------XXXXXX*#
-------XXXXXXXX