-XXXXXXXXXXXXXX
-XXXXXXXXXXXXXX
^XXXXXXXXXXXXXX
^XXXXXXXXXXXXXX
^XXX---#XXXX---
^XXX----XXXX---
#*-------*-----
-XXXXXXXXXXXXXX
-XXXXXXXXXXXXXX
XXXXXXXXXXXXXXX
XXXXXXXXXXXXXXX