XXXXXXX^XXXXXXX
XXXXXXX-XXXXXXX
XXXXXXXXXXXXXXX
XXXXXXXXXXXXXXX
X------X----#XX
XXXXXXXXXX---XX
*XXXXXXXXX----*
XXXXXXXXXXXXXXX
XXXXXXXXXXXXXXX
XXXXXXX*XXXXXXX
XXXXXXX^XXXXXXX