XXXXXXXXXXXXXXX
^XXXXXXXXXXXXXX
^XXXXXX--XX*#XX
^XXXXXX--XX--XX
^XXXXXX--XX--XX
&XXXX----------
^*---XX--XX--XX
^XXXXXX--XX--XX
^XXXXXX*#XX--XX
^XXXXXXXXXXXXXX
XXXXXXXXXXXXXXX