XXXXXXXXXXX^^^^
XXXXXXXXXXX^---
XXXXXXXXXXX^XX-
XXXXXXXXXXX^XXX
XXXXXXXXXXX-XXX
------------X*#
-----------^XXX
XXXXXXXXXXX^XXX
XXXXXXXXXXX^XX-
XXXXXXXXXXX^X--
XXXXXXXXXXX^^^^