^XXXXXXXXXXXXXX
-XXXXXXXXXXXXXX
-XXXXXXXXXXXXXX
-XXXXXXXXXXXXXX
&-------*---#XX
XXXXX--------XX
*XXXX----#----*
-XXXXXXXXXXXXXX
-XXXXXXXXXXXXXX
-XXXXXXXXXXXXXX
^XXXXXXXXXXXXXX