XXXXXXXXXXXXX^^
XXXXXXXXXXXXX--
XXX--XXXXXXXXX-
XXX--XXXXXXXXXX
XXX--XX------XX
XXX----XXXXXX*#
*----XXXXXXXXXX
XXX--XXXXXXXXXX
XXX*&XXXXXXXXX-
XXXXXXXXXXXXX--
XXXXXXXXXXXXX^^