-XXXXXXXXXXXX^^
-XXXXXXXXXXXX--
XXXXXXXXXXXXXX-
XXXXXXXXXXXXXXX
XX-----------XX
XXXXXXXXXXXX-*#
-*XXXXXXXXXX-XX
#XXXXXXXXXXXXXX
-XXXXXXXXXXXXX-
-XXXXXXXXXXXX--
-XXXXXXXXXXXX^^