----XXXXXX^^^^^
----XXXXXX^^^^^
----XXXXXX^^^^^
----XXXXXX^^^^^
----XXXXXX^^^^^
----XXXXXX^^^^^
------XXXX^^^^^
#---------^^^^^
----XX---------
----XXXXXX-----
----XXXXXX^^^^^