-XX^^^^XXXXXXXX
--X-----XX--XXX
--------XX--XXX
------^-XX--XXX
---^^^^--------
--/------------
--\^^^^--------
------^-XX--XXX
--------XX--XXX
--X----#XX*&XXX
-XX^^^^XXXXXXXX