^XXXXXXXXXX^^^^
-XXXXXXXXXX^^^^
-XXXXXXXXXX----
-XXXXXXXXXX----
-XXXXX-----^^^^
-XXXXXX----^^^^
-*----X--#-^^^^
-XXXXXXXXXX^^^^
-XXXXXXXXXX^^^^
-XXXXXXXXXX^^^^
^XXXXXXXXXX^^^^