----^^^XXXXX^^^
----^^^XXXXX^^^
----^^^XXXXX^^^
----^^^--XXX^^^
------------^^-
#------XX------
----^^^XXXXX--^
----^^^XXXXX^^^
----^^^XXXXX^^^
----^^^XXXXX^^^
----^^^XXXXX^^^