^XXXXXXXXXXXXXX
-XXXXXXXXXXXX--
-XXXXXXXXXXXX--
-XXXXXXXXXXXX--
-#XXXX--*------
#-XXXX---------
---*-----#-----
-XXXXXXXXXXXX--
-XXXXXXXXXXXX--
-XXXXXXXXXXXX*#
^XXXXXXXXXXXXXX