X^^XXXXXXXXXXXX
X--XXXXXXXXXXXX
XXXXXXXXXXXXXXX
XXXXXXXXXXXXXXX
-XX-#XXXXXXXX--
-*X--XXXXXXX-#-
#XX---*--------
XXXXXXXXXXXXXXX
XXXXXXXXXXXXXXX
X-*XXXXXXXXXXXX
X^^XXXXXXXXXXXX