---------------
---------------
---^----^---^--
---^----^---^--
---^----^---^--
---^----^---^--
--#-#-#-#-#-#-#
---------------
---------------
XXXXXXXXXXXXXXX
XXXXXXXXXXXXXXX