--XXX--^^^^^^^^
--XXX------X--X
--XXX------X--X
--XXX------X--X
--XXX------X--X
--XXX------X-#X
--XXX------X--X
-----------X--X
-----------X--X
--XXX----------
--XXX--^^^^^^^^