^^^^^^^--XXXXXX
---------XXXXXX
--X------XXXXXX
--XX-----XXXXXX
--XXX-------&--
--*#X----------
--XXX----------
--XX-----XXXXXX
--X------XXXXXX
---------XXXXXX
^^^^^^^--XXXXXX