XXXXXX^^X^^XXXX
XXXXXX--X#*XXXX
XXXXXX-XXXXXXXX
XXXXXXXXXXXXXXX
XXXXXXXX*XX-#XX
XXXXXX-X-XX--XX
*-XXXXXX-XX---*
XXXXXXXXXXXXXXX
XXXXXX\XXXXXXXX
XX----/*XX-XXXX
XXXXXX^^X^^XXXX