^^XXXX^^^^^^^^^
^^XXXX^^^^^^^^^
^^XXXX^^^^^^^^^
^^XXXX^^^^^^---
^^XXXX^^^^^^---
--XXXX^^^^^^---
----XX--^^^^---
^^-------------
^^XX--^^----^^^
^^XXXX^^^^^^^^^
^^XXXX^^^^^^^^^