---XXXXXX^^^^^^
---XXXXXX--X--X
XX-XX*#XX--X--X
XXXXX--XX--X--X
--XXX--XX--X--X
--X-------#X-#X
--XXX--XX--X--X
-#XXX--XX--X--X
--XXX--XX--X--X
--XXXXXXX------
--XXXXXXX^^^^^^