-------------------------
-------------------------
-------------------------
-------------------------
-------------------------
------E---XX-------------
---------XXX-------------
--------XXXX-------------
------EXXXXX-------------
-----<>XXXXX-------------
-----[]XXXXX-------------
----X[]XXXXX-------------
---XX[]XXXXX--X----------
XXXXXXXXXXXXXXXXXXXXXXXXX