-------------------------
-------------------------
-------------------------
-------------------------
-------------------------
SSSS-----------XX--------
--------------XXX--------
-------------XXXX--------
------------XXXXX--------
---ES------XXXXXX--------
--<>------XXXXXXX-------X
--[]-----XXXXXXXX------XX
--[]---XXXXXXXXXX-----XXX
XXXXXXXXXXXXXXXXXXXXXXXXX