-------------------------
-------------------------
-------------------------
-------------------------
-------------------------
SSSSS------SSSSSSSS---SQQ
-------------------------
-------------------------
-------------------------
-----------------------SS
-------------------------
--------B----------------
--------b------------E-E-
------XXXXXXXXXX----XXXXX