-------------------------
-------------------------
-------------------------
-------------------------
-------------------------
--------------------SQQS-
-------------------------
--------------XX---------
SQ-------o----XX---------
--------------XX-----SS--
-------------XXX---------
-------------XXX---------
SSSSS--------XXX---E-E---
----XX-----XXXXX--XXXXXXX