-------------------------
-------------------------
-------------------------
-------------------------
-------------------------
SS-----------------------
-------------------------
-------------------------
--------XSS-SQ-------oo--
-------XXX---------------
------XXXX---------------
-----XXXXX---------------
----XXXXXX--SSSSS--------
XXXXXXXXX-------XX-------