-------------------------
-------------------------
-------------------------
-------------------------
-------------------------
-------------------------
-------------------------
-------------------------
SQ-----------XSS-SQ------
------------XXX----------
-----------XXXX----------
----------XXXXX----------
SSSSS----XXXXXX--SSSSS---
----XX-XXXXXXX-------XX--