-------------------------
-------------------------
-------------------------
-------------------------
-------------------------
SSSSS--------------SSSSSS
-------------------------
-------------------------
-------------------------
-------------------------
-------E-----------------
-----------B-------------
-----------b--E-E--------
------X-XXXXXXXXXXXXX----