-------------------------
-------------------------
-------------------------
-------------------------
-------------------------
SSSSS----------------S---
-------------------------
-------------------------
-----------E--------E-EE-
----------<>------------X
----------[]------------X
----------[]------------X
-------E--[]------------X
------XXXXXXXX---X------X