-------------------------
-------------------------
-------------------------
-------------------------
-------------------------
------------------SQS----
-------------------------
-------------------------
-------------------------
------------------S?S----
------------------------<
------------------------[
-----------------E------[
XXXXXXXXXX-XXXXXXXXXXXX-X