-------------------------
-------------------------
-------------------------
-------------------------
-------------------------
----------------------XXX
---------------------XXXX
-oo-----------------XXXXX
-------------------XXXXXX
-------------------XXXXXX
-----------------XXXXXXXX
----------------XXXXXXXXX
-------------------XXXXXX
--XXX-XXXX-XXXXXXXXXXXXXX