-------------------------
-------------------------
-------------------------
-------------------------
-------------------------
--XX---------------------
--XX---------------------
X-XX---------------------
X-XX-----E---------------
X-XX----<>---------------
X-XX----[]-----E--------X
X-XX----[]-------------XX
X-XX----[]---------E--XXX
X-XXXXXXXXXXX-X-XXXXXXXXX