-------------------------
-------------------------
-------------------------
-------------------------
-------------------------
----------XX--------SSSSS
----------XX-------------
-------XX-XX-------------
-------XX-XX-------------
-------XX-XX-----X-------
------XXX-XX----XX-------
------XXX-XX---XXX-------
------XXX-XX--XXXX-------
-XXXXXXXX-XXXXXXXXXXXX---