-------------------------
-------------------------
-------------------------
-------------------------
-------------------------
----------XX------SSSSSS-
----------XX-------------
-oo----XX-XX-------------
-------XX-XX-------------
-------XX-XX-------------
------XXX-XX----E--------
------XXX-XX---<>--------
------XXX-XX---[]--------
--XXXXXXX-XXXXXXXXXX-----