-------------------------
-------------------------
-------------------------
-------------------------
-------------------------
------------------------S
-------------------------
-oo----------------------
-------------------------
-----------------------XX
--------------------XXXXX
-------B---------XXXXXX--
-------b--------XXXXX----
--XXXXXXXXXXXXXXXXX------