-------------------------
-------------------------
-------------------------
-------------------------
-------------------------
-------------------------
-------------------------
-------------------------
-------------------------
-------------X---QQ------
-------E----XX-----------
-----------XXX---------E-
---E------XXXX-----------
--XXX-X-XXXXXXXXXXXXXX-X-