-------------------------
-------------------------
-------------------------
-------------------------
-------------------------
-------------------------
-------------------------
-------------------------
-------------------------
---------X---------------
--------XXX--------------
-------XXXX--------------
---E--XXXX----E--EE-E-E-E
--XXXXXXXX---XXXXXXXXXXXX