-------------------------
-------------------------
-------------------------
-------------------------
-------------------------
----------------S-------S
-------------------------
-------------------------
---------------E-EE------
-------------------XX-XX-
-------------------XX-XX-
-------B-----------XX-XXX
-------b-----------X--XXX
XXXXXXXXXXXXX------X--XXX