-------------------------
-------------------------
-------------------------
-------------------------
-------------------------
XXX-----------------XX---
XXX----------------XXX---
XXX---------------XXXX---
XXX--S-----E-----XXXXX---
XXX-------<>-----XXXXX---
XXX-------[]---XXXXXXX---
XXX-------[]--XXXXXXXX---
XXX-------[]-----XXXXX---
XXXXXXXXXXXXXXXXXXXXXXXXX