-------------------------
-------------------------
-------------------------
-------------------------
-------------------------
S------------------------
-------------------------
-------------------------
-EE----------------------
---XX-X------------oo----
---XX-X---------E--------
---XX-X------------------
---X--X------------------
---X--X--XXXXX-X-XXXXXX--