-------------------------
-------------------------
-------------------------
-------------------------
-------------------------
S------------------------
-------------------------
-------------------------
-EE----------------------
---XX-X------------------
---XX-X------------------
---XX-X------------------
---X--X------------------
---X--X--X-XXXXXXX-XXX---