-------------------------
-------------------------
-------------------------
-------------------------
-------------------------
------S------------------
-------------------------
-------------------------
o----E-EE----------------
---------XX-X------------
---------XX-X------------
---------XX-X---------<>-
---------X--X---E-EE--[]X
XXX------X--X--XXXXXXXXXX