-------------------------
-------------------------
-------------------------
-------------------------
-------------------------
--S----------------------
-------------------------
-------------------------
-E-EE--------------------
-----XX-X-------E--------
-----XX-X------<>--------
-----XX-X------[]--------
-----X--X---E--[]-E------
-----X--X--XXXXXXXXXX--XX