-------------------------
-------------------------
-------------------------
-------------------------
-------------------------
----------S------------S-
-------------------------
-------------------------
---------E-EE---------E-E
------X------XX-X--------
------X------XX-X--------
------X------XX-X--------
------X------X--X--------
XXXX--X------X--X--X-----