-------------------------
-------------------------
-------------------------
-------------------------
-------------------------
---------------XXXX------
E--------------XXXX------
>-----------XX-XXXX------
]---SSS-----XX-XXXX------
]-----------XX-XXXX------
]----------XXX-XXXX------
]----------XXX-XXXX------
]----------XXX-XXXX--X---
XXXXXXXXXXXXXX-XXXXXXXXXX