-------------------------
-------------------------
-------------------------
-------------------------
-------------------------
SSSQ---------------------
-------------------------
-------------------------
-------------------------
---S-----------------XX--
-----------E---------XX--
-------------------X-XXX-
----E--------------X-XXX-
XXXXXXXXXXXXXXXXXX-X-XXXX