-------------------------
-------------------------
-------------------------
-------------------------
-------------------------
-------------------------
------------XSSS---------
-----------XXX-----------
----------XXXS-----------
----------XXXX-----------
--------XXXXXX-SSS-------
-------XXXXXXX--------B--
----------XXXX--------b--
--XXXXXXXXXXXXXX---XXXXXX