-------------------------
-------------------------
-------------------------
-------------------------
-------------------------
---------------XXXX------
---------------XXXX------
S--o--------XX-XXXX------
------------XX-XXXX------
-SS---------XX-XXXX------
-----------XXX-XXXX------
--SSS------XXX-XXXX------
-----------XXX-XXXX--X---
-----XXXXXXXXX-XXXXXXXXXX