-------------------------
-------------------------
-------------------------
-------------------------
-------------------------
------------------------S
-------------------------
-------------------------
-----o-------------------
-----------------------XX
--------------------XXXXX
-----------------XXXXXX--
----------------XXXXX----
XXXXXXXXXXXXXXXXXXX------