-------------------------
-------------------------
-------------------------
-------------------------
-------------------------
-------------------------
-------------------------
---------XSS--o-------XSS
--------XXX----------XXX-
--------XXX-SS-------XXX-
------XXXXX--------XXXXX-
-----XXXXXX--SSS--XXXXXX-
--------XXX----------XXX-
-XXXXXXXXX------XXXXXXX--