-------------------------
-------------------------
-------------------------
-------------------------
-------------------------
-------------------------
-------------------------
-------------------------
-------------------------
-------------E-----------
------------<>-----------
------------[]---E-------
------------[]--------X--
--XXXX---XX-XXXX-X-XXXXXX