-------------------------
-------------------------
-------------------------
-------------------------
-------------------------
S------------------------
-------------------------
-------------------------
--------------E--------o-
---------XX--<>----------
---------XX--[]----------
---------XX--[]----------
-----EE--XX--[]----------
--XXXXXXXXX--XXXXXXXXX---