-------------------------
-------------------------
-------------------------
-------------------------
-------------------------
----------XX-----------XX
---------XXX----------XXX
--------XXXX---------XXXX
-------XXXXX--------XXXXX
------XXXXXX--------XXXXX
-----XXXXXXX------XXXXXXX
----XXXXXXXX-----XXXXXXXX
---XXXXXXXXX--E-----XXXXX
XXXXXXXXXXXXXXXXXXXXXXXXX