-------------------------
-------------------------
-------------------------
-------------------------
-------------------------
--------------XXXXX-----Q
-------------XXXXXX------
------------XXXXXXX------
-----------XXXXXXXX------
-----------XXXXXXXX-----?
---------XXXXXXXXXX------
--------XXXXXXXXXXX------
-----------XXXXXXXX------
-XXXXXXXXXXXXXXXXXXXXXXXX