-------------------------
-------------------------
-------------------------
-------------------------
-------------------------
SSSSSS-------------------
-------------------------
-------------------------
-------------------------
-------------------------
-------------------------
X------------------------
X------------------------
XXXXXXXXXXXXXXXXXXXXXXXXX