-------------------------
-------------------------
-------------------------
-------------------------
-------------------------
-------------------------
-------------------------
--------------X----------
oo-----------XX------X---
-------------XX-----XX---
-----------XXXX----XXX---
----------XXXXX---XXXX---
-------------XX--XXXXX--X
XXXXXXXXXXXXXXXXXXXXXXXXX