-------------------------
-------------------------
-------------------------
-------------------------
-------------------------
--------SSSSSSSS---------
-------------------------
------------------------X
-----------------------XX
-----------------------XX
---------------------XXXX
--------------------XXXXX
-----------------------XX
------XXXX-------XXXXXXXX