-------------------------
-------------------------
-------------------------
-------------------------
-------------------------
--SSSSSSSSS---SSSSSS-----
-------------------------
-------------------------
-------------------------
-------------------------
-------------------------
-------------------------
-------------------------
XXXX--------XXXX-----XXXX