-------------------------
-------------------------
-------------------------
-------------------------
-------------------------
SS-----------------------
-------------------------
-------------------------
---------E----------oo---
XXX-----<>---------------
-----X--[]---------------
-----X--[]---------------
-----X--[]-EE------------
X----XXXXXXXXX-XXXX----X-