-------------------------
-------------------------
-------------------------
-------------------------
-------------------------
-----------SSSSSS--------
-------------------------
-------------------------
------------------------X
------------------------X
----------------------XXX
---------------------XXXX
------------------------X
---------XXXX-----XXXXXXX