-------------------------
-------------------------
-------------------------
-------------------------
-------------------------
------SSSSSSSSSS-----SSSS
-------------------------
-------------------------
-------------------------
-------------------------
-------------------------
-------------------------
-------------------------
---XXXXX---------XXXXXX--