-------------------------
-------------------------
-------------------------
-------------------------
-------------------------
-----SS------SSS---------
-----------------------oo
-------------------------
---------------------E---
----XXXX----XXXXX---<>---
-XXXXX------X-------[]---
XXXX--------X-------[]---
XX----------X-------[]---
------XX--XXXXX-----XXXXX