-------------------------
-------------------------
-------------------------
-------------------------
-------------------------
----SSSSSSSSSSSSSSS------
E------------------------
>------------------------
]------------------------
XX-----------------------
-----------------------XX
----------------------XXX
-------------------------
XXXXXX--------------XXXXX