-------------------------
-------------------------
-------------------------
-------------------------
-------------------------
-----------------XX--SSSS
-----------------XX------
---------------X-XX------
---------------X-XX------
-------------X-X-XX------
-------------X-X-XX------
-------------X-X-XX------
-------------X-X-XX------
---------X---X-X-XXXXXX--