-------------------------
-------------------------
-------------------------
-------------------------
-------------------------
S----S------------------S
-------------------------
-------------------------
----E-EE-----------------
XX------XX-X---------E-XX
--------XX-X--------<>-X-
--------XX-X--------[]-X-
--------X--X--------[]-X-
--------X--X--X---XXXXXXX