-------------------------
-------------------------
-------------------------
-------------------------
-------------------------
---?-----S---------S-----
-------------------------
-------------------------
--------E-EE------E-EE---
---Q--------XX-X------XX-
------------XX-X------XX-
------------XX-X------XX-
------------X--X------X--
-XXXXX------X--X------X--