-------------------------
-------------------------
-------------------------
-------------------------
-------------------------
--------------XX--SSSQ---
----oo-------XXX---------
------------XXXX---------
--E--------XXXXX---------
-<>--------XXXXX-----S---
-[]------XXXXXXX---------
-[]-----XXXXXXXX---------
-[]--------XXXXX------E-E
XXXXXXXXXXXXXXXXXXXXXXXXX