-------------------------
-------------------------
-------------------------
-------------------------
-------------------------
XX-----------------------
XX--------XSSS----------X
XX-------XXX-----------XX
XX------XXXS----------XXX
XX------XXXX----------XXX
XX----XXXXXX-SSS----XXXXX
XX---XXXXXXX-------XXXXXX
XX------XXXX----------XXX
XXXXXXXXXXXXXX---XXXXXXXX