-------------------------
-------------------------
-------------------------
-------------------------
-------------------------
-------------------------
-------------------------
-------------------------
-------------------------
------------SSS----------
-----------------E-------
----------------<>-------
----------------[]-EE----
XXXXXXXXXXXXXXXXXXXXXXXXX