-------------------------
-------------------------
-------------------------
-------------------------
-------------------------
-------------------------
-------------------------
-------------------------
-------------------------
-----------------------XX
----------------------XXX
---------------------XXXX
--------------------XXXXX
---XXXXXXXXXXXXXXXXXXXXXX