-------------------------
-------------------------
-------------------------
-------------------------
-------------------------
SSSS-----------XXXXXX----
--------------XXXXXXX----
-------------XXXXXXXX----
------------XXXXXXXXX----
------------XXXXXXXXX--oo
----------XXXXXXXXXXX----
---------XXXXXXXXXXXX----
------------XXXXXXXXX----
X----XXXXXXXXXXXXXXXXXXXX