-------------------------
-------------------------
-------------------------
-------------------------
-------------------------
-----------------S-------
-------------------------
-------------------------
-------------------------
QQ---SS----E---QQQQ------
---------E<>-------------
--------<>[]-------------
--------[][]-------------
XXXXXXXXXXXXXXXXXXXXX--XX