-------------------------
-------------------------
-------------------------
-------------------------
-------------------------
-----------------XXX-----
----------------XXXX-----
---------------XXXXX-----
--------------XXXXXX-----
--------------XXXXXX-----
------------XXXXXXXX-----
-----------XXXXXXXXX-----
--------------XXXXXX-----
--X-XXXX-XXXXXXXXXXXXXXX-