-------------------------
-------------------------
-------------------------
-------------------------
-------------------------
------------XX-----------
-----------XXX-----------
----------EXXX---E-------
---------XXXXX--<>-------
--------XXXXXX--[]------E
-------XXXXXXX--[]-----<>
------XXXXXXXX--[]-----[]
-----XXXXXXXXX--[]-----[]
-X-XXXXXXXXXXXXXXXXXX--XX