-------------------------
-------------------------
-------------------------
-------------------------
-------------------------
-------------------------
------------------------X
-----------------------XX
----------------------XXX
----------------------XXX
--------------------XXXXX
-------------------XXXXXX
----------------------XXX
-------XXXXXXXXXXXXXXXXXX