-------------------------
-------------------------
-------------------------
-------------------------
-------------------------
-------------------------
----------------------XSS
---------------------XXX-
--------------------XXXS-
--------------------XXXX-
------------------XXXXXX-
-----------------XXXXXXX-
--------------------XXXX-
--------XXXXXXXXXXXXXXXXX