-------------------------
-------------------------
-------------------------
-------------------------
-------------------------
-------------------XXX---
------------------XXXX---
-----------------XXXXX---
----------------XXXXXX---
----------------XXXXXX---
--------------XXXXXXXX---
-------------XXXXXXXXX---
----------------XXXXXX---
---------XXXXXXXXXXXXXXXX