-------------------------
-------------------------
-------------------------
-------------------------
-------------------------
---SSSSSSSS---------XX---
-------------------XXX---
------------------XXXX---
-----------------XXXXX---
-----------------XXXXX---
---------------XXXXXXX---
--------------XXXXXXXX---
-----------------XXXXX--E
-XXXX-------XXXXXXXXXXXXX