-------------------------
-------------------------
-------------------------
-------------------------
-------------------------
------SSSSSSS------------
-------------------------
-------------------------
-----------------------o-
-------------------------
-------------------------
-------------------------
---X---------------------
XXXXXXXX------XXXXXXX----