-------------------------
-------------------------
-------------------------
-------------------------
-------------E-----------
---------SSSSSS----------
-------------------------
------------------------<
----------E-------------[
----X----SSSSSS---------X
----X---------------E----
----X--------------<>----
----X-----------E--[]----
----X--XXXXXXXXXXXXXXXXXX