-------------------------
-------------------------
-------------------------
-------------------------
-------------------------
-------------------------
-------------------------
-------------------------
-------------------------
-------------------------
-------------------------
------E------------------
-----------EE-EE---------
-XXXX-X-XXXXXXXXX--XXX--X