-------------------------
-------------------------
-------------------------
-------------------------
-------------------------
--SSSSS-------SSSSSS-----
-------------------------
-------------------------
-------------------------
-------------------------
-------------------------
-------------------------
-------------------------
XXXX----X---XXXX-----XXXX