####--M----#----------###
####--M----#-----#-----M#
--#---M----#-----#-----MH
--#---M----------#-----M-
--#---M----------#-----M-
------M--------#H------M-
------M-#------#H------M-
------#--------#H--#---M-
DD----M--------##--#---M-
####--M------#H----#---M-
####--M------#H----#---M-
-H----M------#H----#---M-
------M----#DD#----#---M-
--T---M----#-----------M-
--T---M----#-----------MH
####--M----#----------###