T###########M-###--------
T#DDD#######M------------
T#---#######M------------
T#-----#DDDDM---T--------
T------#----M---T------##
T------#----M-----------#
T------#----M----H------#
T------#----M-----------#
T------#----M------T----#
T-----------M------T----#
------------M------T----#
-------T----M------T----#
------------M----H-------
-D----------M------------
------#-----M------------
-############------------