####-M---##---#-------#--
####-M---##---#-----#-M--
--#--MH--##---#-----#-M--
--#--M---##---------#-M--
--#--M--------------#-M--
-----M------------#H--M--
-----###----#-----#H--MH-
-----M------------#H--M--
DD---M------------##--M--
####-M----------#H----M--
####-MH---------#H----M--
-H---M----------#H----M--
-----M---##---#DD#----MH-
--T--M---##---#-------M--
--T--M---##---#-------M--
####-M---##---#-------M--