--#---####---##-M--M--T-#
###---#########-M--M--T-#
###############-MH-M--T-#
##-##########-#-M--M--T-#
##-####---###---M--MH-T#-
---####---#-----M--M--T#-
----#-----H-----M--M---#-
-H--#--H----H---M--M---#-
-#--#--#----#---M--M--T--
-#--H--#----#---M--M--T--
-#-----#----#---M--M--T--
##--H--#--###---MH-M--T--
##-#####--###---M--M--T--
##-#####--###---M--MH-TDd
########Dd#####-M--M--T--
--########---##-M--M--T##