#####-###################
#####-###################
###-###############-#####
D##--#####DDDDDDDD#######
-----##------------##----
-----##------------##----
-------------------##----
---H---H------------#-T-T
-------#------------#-T-T
-------#------------#-T-T
-T-----#----------T---T-T
-T-T---#--------------T-T
#T#T-###----------####T#T
#T#T-###----------#-##T#T
###T######--------#-##T#T
#########################