------M-M--M--#--M--M--#-
------M-M--M--M--M--M--M-
------M-M--M--M--M--M--M-
------M-M--M--M--M--M--M-
------M-MH-M--M--MH-M--M-
------M-M--M--M--M--M--M-
------M-M--M--MH-M--M--MH
--T---#-M--M--M--M--M--M-
--T---M-M--MH-M--M--M--M-
--T---M-M--M--M--M--M--M-
--T---M-M--M--M--M--M--M-
------M-M--M--M--M--M--M-
------M-M--MH-MH-M--M--MH
------M-MH-M--M--MH-M--M-
------M-M--M--M--M--M--M-
------M-M--M--M--M--M--M-