######-###-M--#--------M-
######-###-M--M--------M-
-----T-###-M--M--------MH
-----------M--M-----T--M-
-----------M--M---T-T--M-
-----------M--M---T-T--M-
-----------M--M-T-TD---M-
-----------M--M-T-T----M-
-----------MH-M-T----T-M-
-----------M--M-T----T-M-
--------T--M--M-T----T-M-
--------T--M--M-T----T-MH
-----------MH-M-T------M-
-----------M--M-T------M-
DDDDDD-###-M--M--------M-
######-###-M--M--------M-