------#M####-#--M--------
------#M####-M--M###-----
-######M####-M--M#####---
-######M####-M--M#####---
-######M#----M--M#####---
-######M#----M--M#--##---
--#-#--M-----MH-MH--#----
--#-#--M-H---M--M--H#----
--#-#--M-#---M--M--##----
H-H-H--M-#---M--M--#H--T-
H------M-#---M--M--#---T-
H-H-H--M-#---M--M###H--T-
#######M##---MH-M#####-T-
-######M##---M--M#####---
-######M##Dd-M--M#####---
-######M####-M--M---##---