---###---##-#--M-M-M--###
---########-M--M-M-M--###
###########-M--M-M-M--###
#########-#-M--M-M-M--###
####--###---M--M-M-MH-#--
####--#-----M--M-M-M--#--
-#----H-----MH-M-M-M-----
-#--H---H---M--M-M-M---H-
-#--#---#---M--M-M-M---#-
-H--#---#---M--M-M-M---#-
----#---#---M--M-M-M---#-
-H--#-###---M--M-M-M---#-
#####-###---MH-M-M-M--##-
#####-###---M--M-M-MH-##-
###########-M--M-M-M--##D
######---##-M--#-M-M--###