###---#######-#-------###
#D#---###DDD#-M-------###
#-----###-----M##########
#-----###-----M##########
--------#-----M########--
--------#-----M########--
--------#-----M-#-#-#----
--------#-----M-#-#-#--H-
--------------M-#-#-#--#-
----T---------M-H-H-H--#-
----TH--------M--------#-
----T---------M-H-H-H--#-
--#---#######-M#########-
D-#---#######-M#########-
--#---#######-M#########D
###---#######-M##########