-###---#----#-#-----M--#-
-#D#---M----M-M-----M--M-
-#-----M----M-M-----MH-M-
-#-----M----M-M-----M--M-
#------M----M-M-----M--M-
#------M----M-M-----M--M-
#------MH---M-MH----M--MH
#------M----M-M-----M--M-
-------M--T-M-M-----M--M-
-------M--T-M-M--#--M--M-
-------M--T-M-M--#--M--M-
-------M--T-M-M--#--MH-M-
---#---MH---M-MH-#--M--MH
DD-#---M----M-M-----M--M-
---#---M----M-M-----M--M-
####---M----#-M-----M--M-