##----###TM---##M--M--M--
-M----###TM----#M--M--M--
-M--#####TMH---MMH-M--M--
-M--#####TM----MM--M--M--
-M--###--TM----MM--MH-MH-
-M--###--TM----MM--M--M--
-M--#-----##---MM--M--M--
-M--#--H--M----MM--M--M--
-M--#--#--M----MM--M--M--
-M--H--#--M--#-MM--M--M--
-M-----#--MH-#-MM--M--M--
-M--H--#--M--#-MMH-M--M--
-M--####--M--#-MM--M--M--
-M--####--M----MM--MH-MH-
-M--####D#M----MM--M--M--
##--######M-####M--M--M--