######------####-#-M-----
######------####-D-M-----
-----T------####---M-----
------------DDDD---M-----
-------------------MH----
-------------------M-----
-------------------M---T-
-------------------M-----
-------------------M-----
-------------------M-----
-------------------M-----
---------#---------M-----
-------------------M----#
-------------------MH---#
DDDDDD-------------M----#
######------####-#-M---##