###---#######-#########--
#D#----######-#DDDDDD##--
#------#####--#--------H-
#---T--#DDDD--#----------
----T--#------#----------
----T--#------#----------
----T--#------#----------
-------#------#----------
-------#------#----------
----T---------#----------
----T--------------------
----T--T---------------H-
--#-T-------#------------
D-#---------#------------
--#---------#------------
###---#######-#########--