--######-###-####-MM-#M--
--M#-###-###-#####MM--M--
##MH-M---#########MM--MH-
##M--M---#--######MM--M--
##M--M------##---#MMH-M--
##M--M------##---#MM--M--
#-M--M-----------HMM--M--
#-M--M---H----H---MM--M--
#-M--M---#----#---MM-#M--
H-M--M---#----#---MM--M--
--M--M---#T---#---MM--M--
H-M--M-###T---#--#MM--MH-
##M--M-###--###--#MM--M--
##M--M-#-#--###--#MMH-M--
##MH-M-#-######Dd#MM--M--
########-########-MM-#M--