--#---M-M--M--#--M--M--M-
--#---M-M--M--M--M--M--M-
--#---M-M--M--M--M--MH-MH
--#-T-M-M--M--M--M--M--M-
----T-M-MH-M--M--MH-M--M-
----T-M-M--M--M--M--M--M-
----T-M-M--M--MH-M--M--M-
------#-M--M--M--M--M--M-
------M-M--MH-M--M--M--M-
----T-M-M--M--M--M--M--M-
----T-M-M--M--M--M--M--M-
----T-M-M--M--M--M--MH-MH
----T-M-M--MH-MH-M--M--M-
------M-MH-M--M--MH-M--M-
-##---M-M--M--M--M--M--M-
-##---M-M--M--M--M--M--M-