####--####---####--M-----
####--#####-#######M--###
#--########-#######M--###
#--########-#######M--###
#--####---####---##MH-###
----###---#--#---#-M--#--
----#-----H------H-M--H--
----#--H----H-H----M----H
----#--#----#-#----M----#
####H--#----#-#----M----#
####---#----#-#----M----#
--H-H--#--#-#-#--##M--###
----####--#-###--##M--###
T--T####--#-###--##MH-###
T--T####Dd#-###Dd##M--###
##########---####--M-----