##--###---####----#---###
##--##########-####---###
--############-##########
--########---#-###-######
--###--###-----###-####--
--###--#-------#---####--
--#----H-------H----#----
--#--H---H-------H--#--H-
DD#--#---#-------#--#--#-
##H--#---#-------#--H--#-
##---#---#-T-----#-----#-
-HH--#-###-T---###--H--#-
--####-###-----###-#####-
--####-###-----###-#####-
--####D#######-#########D
#######---####----#######