#-----#############---###
########-##########---###
######---M#--############
######---M#--DDDDD#######
-#####---MH--------####--
-#-------M---------####--
-H-------M----------#----
-----H---M----------#--H-
-----#---M----------#--#-
-----#---M----------H--#-
-----#---M--------T----#-
-#####---M----------H--#-
-#######-MH-------######-
-#####---M#-------######-
D#####T--M#-------######D
#-----###################