###---#######-#--M--M--M-
#D#---###DDD#-M--M--M--M-
#-----###-----M--M--MH-MH
#-----###-----M--M--M--M-
--------#-----M--MH-M--M-
--------#-----M--M--M--M-
--------#-----MH-M--M--M-
--------#-----M--M--M--M-
--------------M--M--M--M-
----T---------M--M--M--M-
----TH--------M--M--M--M-
----T---------M--M--MH-MH
--#---#######-MH-M--M--M-
D-#---#######-M--MH-M--M-
--#---#######-M--M--M--M-
###---#######-M--M--M--M-