##----####---##-M--M--###
##----#########-M--M--###
--#############-MH-M--###
--###########-#-M--M--###
--#####---###---M--MH-#--
--#####---#-----M--M--#--
--#-#-----H-----M--M-----
--#-#--H----H---M--M---H-
Dd#-#--#----#---M--M---#-
##H-H--#----#---M--M---#-
##-----#----#---M--M---#-
-HH-H--#--###---MH-M---#-
--######--###---M--M--##-
--######--###---M--MH-##-
--######Dd#####-M--M--##D
##########---##-M--M--###