------#####-####M--#--###
------######M#-#M###--###
##########M#MH-MM##---###
##########M#M--MM##---###
#######---M#M--MM##--T#--
#######---M#M--MM#---T#--
#-#-#-----MHM--MMH---T---
#-#-#--H--M-M--MM----T-H-
#-#-#--#--M-M--MM------#-
H-H-H--#--M-M--MM------#-
-------#--M-M--MM------#-
H-H-H--#--M#M--MM##----#-
########--M#M--MM###--##-
########--M#M--MM###--##-
########DdM#MH-MM###--##D
###########-####M--#--###