####--################-#-
####---###############-M-
--#----###############-M-
--#----#DDDDDDDDDD####-M-
--#----#---------------M-
-------#---------------M-
-------#---------------MH
-------#---------------M-
DD-----#---------------M-
####-------------------M-
####--------------T-T--M-
-H-----T------------T--M-
------------------##T#-MH
--T---------------##T#-M-
--T---------------####-M-
####--################-M-