------####---###M--M##---
------########-#M--MM#---
##############-MMH-MMH###
#############--MM--MM-###
#######---###--MM--MM-###
#######---#----MM--MM-###
#-#-#-----H----MM--MM-#-#
#-#-#--H----H--MM--#M-#-#
#-#-#--#----#--MM--MM-#-#
H-H-H--#----#--MM--MM-H-H
-------#----#--MM--MM----
H-H-H--#--###--MMH-MM-H-H
########--###--MM--MM-###
########--###--MM--MM-###
########Dd####-MM--MMH###
##########---###M--M#####