#####--#---M--#--M--M--M-
-####--M---M--M--M--M--M-
---#---M---M--M--M--MH-MH
#--#---M---M--M--M--M--M-
#--#---M---M--M--MH-M--M-
#------M---M--M--M--M--M-
#------MH--M--MH-M--M--M-
#------M---M--M--M--M--M-
#DD----M---MH-M--M--M--M-
-####--M---M--M--M--M--M-
-####--M---M--M--M--M--M-
T-H----M---M--M--M--MH-MH
T------MH--MH-MH-M--M--M-
---T---M---M--M--MH-M--M-
---T---M---M--M--M--M--M-
#####--M---M--M--M--M--M-