######-M---M--#--M-M-###-
######-M---M--M--M-M-####
-----T-M---M--M--M-M-####
-------M---M--M--M-M-####
-------M---M--M--M-M-#--#
-------M---M--M--M-M-#--#
-------M---M--MH-M-M----H
-------M-T-M--M--M-M--H--
-------M-T-MH-M--M-M--#--
-------M-T-M--M--M-M--#--
-------M---M--M--M-M--#--
-------M---M--M--M-M--#-#
-------M---MH-MH-M-M-##-#
-------M---M--M--M-M-##-#
DDDDDD-M---M--M--M-M-##D#
######-#---M--M--M-M-###-