---#--M-M--M--#----MM--M-
---M--M-M--M--M----MM--M-
---M--M-M--M--M----MMH-MH
---M--M-M--M--M----MM--M-
---M--M-MH-M--M----MM--M-
---M--M-M--M--M----MM--M-
---MH-M-M--M--M----MM--M-
---M--#-M--M--M----MM--M-
---M--M-M--MH-M----MM--M-
---M--M-M--M--M-#H-MM--M-
---M--M-M--M--M-#H-MM--M-
---M--M-M--M--M-#H-MMH-MH
---MH-M-M--MH-MDD#-MM--M-
---M--M-MH-M--M----MM--M-
---M--M-M--M--M----MM--M-
---M--M-M--M--M----MM--M-