#-M-----###########---###
#-M-----###########---###
T-M-----#################
--M-----DDDDDDDDDD#######
--M----------------####--
--M----------------####--
--M-----------------#----
--M-----------------#--H-
--MH----------------#--#-
--M-----------------H--#-
--M---------------T----#-
--M-----------------H--#-
--MH--------------######-
--M---------------######-
D-M---------------######D
#-M-----#################