---#############------###
---###-#########------###
-----T-##################
-------#DDDDDDDD#######--
-------#--------#######--
-------#--------#######--
-------#--------#-#-#----
-------#--------#-#-#----
-------#--------#-#-#----
----------------H-H-H----
-------------------------
-------T--------H-H-H----
----------------#######--
----------------#######--
---DDD----------#######DD
---######################