---#--M-M--#--#---#M---M-
---M--M-M--M--M---#M---M-
---M--M-M--M--M---#M---MH
---M--M-M--M--M---DM---M-
---M--M-MH-M--M----MH--M-
---M--M-M--M--M----M---M-
---MH-M-M--M--M----M---M-
---M--M-M--M--M----M---M-
---M--M-M--MH-M----M---M-
---M--M-M--M--M-#H-M---M-
---M--M-M--M--M-#H-M---M-
---M--M-M--M--M-#H-M---MH
---MH-M-M--MH-MDD#-M---M-
---M--M-MH-M--M----MH--M-
---M--M-M--M--M----M---M-
---M--M-M--M--M---#M---M-