------#####-####M--M#####
------######M#-#M##MM####
##########M#MH-MM##MMH###
##########M#M--MM##MM-###
#######---M#M--MM##MM-#--
#######---M#M--MM#-MM-#--
#-#-#-----MHM--MMH-MM----
#-#-#--H--M-M--MM--#M--H-
#-#-#--#--M-M--MM--MM--#-
H-H-H--#--M-M--MM--MM--#-
-------#--M-M--MM--MM--#-
H-H-H--#--M#M--MM##MM--#-
########--M#M--MM##MM-##-
########--M#M--MM##MM-##-
########DdM#MH-MM##MMH###
###########-####M--M#####