------M-M--M--#----M---M-
------M-M--M--M----M---M-
------M-M--M--M----M---MH
------M-M--M--M----M---M-
-T----M-MH-M--M----MH--M-
-T----M-M--M--M----M---M-
-TDDDDM-M--M--M----M---M-
-T----#-M--M--M----M---M-
------M-M--MH-M----M---M-
------M-M--M--M-#H-M---M-
------M-M--M--M-#H-M---M-
------M-M--M--M-#H-M---MH
------M-M--MH-MDD#-M---M-
------M-MH-M--M----MH--M-
------M-M--M--M----M---M-
------M-M--M--M----M---M-