########----#############
----####----DDDDDDDDDDDDD
-T----#------------------
---#--#------------------
---#--#------------------
####---------------------
####---------------------
####-----#---------------
####DD---##--------------
----####--H--------------
----####-#H--------------
---T-H---#H--------------
---T-----###-------------
H-----T--###-------------
##----T--###-------------
########-################