###---------------T-M--#-
###---------------T-M----
###---------------T-M----
###---------------T-#----
------------------T-M----
--------------------M----
--------#-----------M----
-----T--#-T---------M----
-----T--#-T---------M----
-#---T--#-----------M----
-#---T--------------M----
-#---T----------#---M----
###---------T-----T-M----
###---------T-----T-M----
###---------T-----T-M----
###---------T-----T-M----