--T-------###-T------M---
--T-------###-T------M-T-
--T-------###-T------M-T-
--T-------###-T------M-T-
-----------#---------M-T-
-----------#---------M---
----T------#-------#-M---
----T--T---#---------#-T-
#---T--T---#--T------M-T-
#---T--T---#--T------M---
#---T--T------T------M---
#---T---------T------M---
##--T-----###-T--#---M---
##--T-----###-T------M---
##--------###-T------M---
##--------###-T------M---