########--#####---#####--
########--#####----####--
##-#-----######-----###--
##-#-----######--T--#####
---#-#---##------T-----##
---#-#---##------T-----##
---#-#-----------TT----##
---#-#-----H------T------
---#-##----#------T------
---#-##----#------T------
-----##----#-------------
-----##----#-------------
##---###-###--------#####
##---###-###--------#####
########-#######---######
########-######---#######