-----#####-----------M-#-
-------T-------------M---
-------T-------------M---
------------T--------M---
------------T--------M---
------------T--------M---
--##--------T--------M---
----------------T----#---
----------------T----M---
----------------T----M---
----------------T----M---
---------------------M---
---------------------M---
---------------------M---
---------------------M---
---------------------M---