---------------M---------
--T------------M---------
---------------M---------
---------------M---------
---------------M---------
----------T----M---------
------T--------M-----#---
----T-T--------M-----#---
----T-T--------M-----#---
------T--------M-----#---
------T--------M---------
------T--------M---------
------T------T-M---------
------T------T-M---------
-------------T-M---------
-------------T-M---------