###-#--M-#--####M--M--###
##M-M--M-M--M###M--M--M##
--M-M--M-M--MH##MH-M--M##
--M-M--M-M--M-##M--M--M##
--M-M--M-M--M---M--MH-M--
--M-M--M-M--M---M--M--M--
--M-MH-M-MH-M---M--M--M--
--M-M--M-M--M-H-M--M--MH-
DdM-M--M-M--M-#-M--M--M#-
##M-M--M-M--M-#-M--M--M#-
##M-M--M-M--M-#-M--M--M#-
-HM-M--M-M--M-#-MH-M--M#-
--M-MH-M-MH-M-#-M--M--M#-
--M-M--M-M--M-#-M--MH-M#-
--M-M--M-M--MH#DM--M--M#D
###-M--M-M--####M--M--###