##----M-M--M--#--M--M--M-
##----M-M--M--M--M--M--M-
------M-M--M--M--M--MH-MH
------M-M--M--M--M--M--M-
------M-MH-M--M--MH-M--M-
------M-M--M--M--M--M--M-
--DDH-M-M--M--MH-M-DM--M-
------#-M--M--M--M--M--M-
------M-M--MH-M--M--M--M-
------M-M--M--M--M--M--M-
------M-M--M--M--M--M--M-
------M-M--M--M--M--MH-MH
----H-M-M--MH-MH-M--M--M-
------M-MH-M--M--MH-M--M-
DD----M-M--M--M--M--M--M-
##----M-M--M--M--M--M--M-