#---###-#################
#---####DDDDDDDDDD##DDDDD
########-----------#-----
-#######-----------#-----
-####--#-----------##----
-####--#-----------#-----
--#----H-----------#-----
--#--H-------------#-----
--#--#-------------##----
--H--#-------------#-----
-----#-------------#-----
--H--#-#-----------#-----
-#####-#-----------------
-#####-#-----------------
######D#-----------------
#######-#################