###---###################
#D#---###DDDDDDDDDDDDDDDD
#-----###----------------
#-----###----------------
--------#----------------
--------#----------------
--------#----------------
--------#----------------
-------------------------
----T--------------------
----TH-------------------
----T--------------------
--#---######-------------
D-#---######-------------
--#---######-------------
###---###################