#---###-##############-#-
#---####DDDDDDDDDDDDD#-M-
########---------------M-
-#######---------------M-
-####--#---------------M-
-####--#---------------M-
--#----H---------------MH
--#--H-----------------M-
--#--#-----------------M-
--H--#-----------------M-
-----#-----------------M-
--H--#-#---------------M-
-#####-#---------------MH
-#####-#---------------M-
######D#---------------M-
#######-##############-M-