####--###################
####---###DDDDDDDDDDDDDDD
#--T---###---------------
#------#DD---------------
-------#-----------------
-------#-----------------
-------#-----------------
-------#-----------------
-------#-----------------
-------------------------
-------------------------
#------T-----------------
#------------------------
#------------------------
#DDD---------------------
####--###################