#---###---###############
#---##########DDDDDDDDDDD
##############-----------
-#########DDDD-----------
-####--###---------------
-####--#-----------------
--#----H-----------------
--#--H---H---------------
--#--#---#---------------
--H--#---#---------------
-----#---#---------------
--H--#-###---------------
-#####-###---------------
-#####-###---------------
######D###---------------
#######---###############