---#--#####-#####---###--
---#--######MM######M##--
###H#-######MM######M####
###-#-######MM######M####
###-#-#----#MM---###M--##
###-#-#----#MM---#--M--##
#-#-#H-----HMM---H--M---#
#-#-#--H-H--MMH----HMH--#
#-#-#--#-#--MM#----#M#--#
H-H-H--#-#--MM#----#M#--H
-------#-#--MM#----#M#---
H-H-H--#-#-#MM#--###M#--H
###-#H##-#-#MM#--###M#-##
###-#-##-#-#MM#--###M#-##
###H#-##D#D#MM#Dd###M#D##
#####-#####-#M###---#####