#####--M-#--####M--M--M-M
##M#M--M-M--M###M--M--M-M
--MHM--M-M--MH##MH-M--M-M
--M-M--M-M--M-##M--M--M-M
--M-M--M-M--M---M--MH-MHM
--M-M--M-M--M---M--M--M-M
--M-MH-M-MH-M---M--M--M-M
--M-M--M-M--M-H-M--M--M-M
DdM-M--M-M--M-#-M--M--M-M
##M-M--M-M--M-#-M--M--M-M
##M-M--M-M--M-#-M--M--M-M
-HM-M--M-M--M-#-MH-M--M-M
--M-MH-M-MH-M-#-M--M--M-M
--M-M--M-M--M-#-M--MH-MHM
--MHM--M-M--MH#DM--M--M-#
####M--M-M--####M--M--M-#