#####--M-#--####M-M-#####
####M--M-M--M###M-M-#####
----M--M-M--MH##MHM-#####
----M--M-M--M-##M-M-#####
----M--M-M--M---M-MH#----
----M--M-M--M---M-M-#----
----MH-M-MH-M---M-M------
----M--M-M--M-H-M-M--H-H-
DdDdM--M-M--M-#-M-M--#-#-
####M--M-M--M-#-M-M--#-#-
####M--M-M--M-#-M-M--#-#-
-H-HM--M-M--M-#-MHM--#-#-
----MH-M-MH-M-#-M-M-##-#-
----M--M-M--M-#-M-MH##-#-
----M--M-M--MH#DM-M-##D#D
####M--M-M--####M-M-#####