#---###--#######-#-M#####
################-#-M#DDDD
####-T############-M#----
####--###DDDDDDD#D-M#----
-###---##-------#--M##---
-#-----#--------#--M#----
-H-----H--------#--M#----
---H------------#--M#----
---#------------#--M##---
---#------------H--M#----
---#---------------M#----
-###---##-------H--M#----
-###---##-------#--M-----
-###---##-------#--M-----
D###DDD##-------#--M-----
#---###--#########-M#####