##-###---#######------###
##-###---#######------DDD
---------#############---
---------DDDDDDD######---
------H---------######---
----------------######---
--------#-------#-#-#----
--------#-------#-#-#----
-----D--#-------#-#-#----
--H--#--#-------H-H-H----
--H--#-------------------
--H--H----------H-H-H----
--#-------------######---
------H---------######---
DD-DD-----------######---
##-###---################