##-###-#---M--#--------##
##-###-M---M--M-----#--D#
-------M---M--M-----#----
-------M---M--M-----#----
------HM-H-M--M-----#----
-------M---M--M---#H-----
-------MH--M--M---#H-----
-------M---M--M---#H-DD--
-----D-M---MH-M---##-----
--H--#-M---M--M-#H-------
--H--#-M---M--M-#H-------
--H--H-M---M--M-#H-------
--#----MH--MH-MDD#-------
------HM-H-M--M----------
DD-DD--M---M--M----------
##-###-M---M--M--------##