###-#--M###-##-#M-M-#####
#MM-M--M#MM-M#-#M-M-M#M##
#MM-M--M#MM-MH-MMHM-MHM##
#MM-M--M#MM-M--MM-M-M-M##
-MM-M--M-MM-M--MM-MHM-M--
TMM-M--M-MM-M--MM-M-M-M--
-MM-MH-M-MMHM-HMM-M-M-M--
-MM-M--M-MM-M--MM-M-M-MH-
-MM-M--M-MM-M--MM-M-M-M#-
-MM-M--M-MM-M--MM-M-M-M#-
-MM-M--M-MM-M--MM-M-M-M#-
-MM-M--M-MM-M--MMHM-M-M#-
#MM-MH-M-MMHM-HMM-M-M-M#-
#MM-M--M-MM-M--MM-MHM-M#-
#MM-M--MDMM-MH-MM-M-MHM#D
###-M--M#MM-##-#M-M-#####