##-###--####--#-----#####
##-###--####--M------M###
--------####--M------MH##
--------DDDD--M------M---
------H-------M------M---
--------------M---#H-M---
--------------M---#H-M---
--------------M---#H-M---
-----D------H-M---##-M---
--H--#--------M-#H---M---
--H--#--------M-#H---M---
--H--H--------M-#H---M---
--#---------H-MDD#---M---
------H-------M------M---
DD-DD---------M------MHDD
##-###--####--M-----#####