-###--###################
-#D#--DDDDDDDDDDDDDDDDDDD
-#-----------------------
-#-----------------------
#------------------------
#------------------------
#------------------------
#------------------------
-------------------------
-------------------------
-------------------------
-------------------------
---#---------------------
DD-#---------------------
---#---------------------
####--###################