######-#############M--M-
##D###-#############M--M-
-----T-#########-###MH-MH
-------#DDDDDDDD-D##M--M-
------H#------------M--M-
-------#------------M--M-
-------#------------M--M-
-------#------------M--M-
-------#--------D---M--M-
----------------#---M--M-
----------------#-T-M--M-
-------T--------H---MH-MH
------------------##M--M-
------H-----------##M--M-
DD-DDD------------##M--M-
######-#############M--M-