#####--M-#--##--M-M-##M#-
##M#M--M-M-#M#--M-M-M#MM-
--MHM--M-M-#MH--MHM-MHMM-
--M-M--M-M-#M---M-M-M-MM-
--M-M--M-M-#M---M-MHM-MM-
--M-M--M-M-#M---M-M-M-MM-
--M-MH-M-MHHM-H-M-M-M-MMH
--M-M--M-M--M---M-M-M-MM-
DdM-M--M-M--M---M-M-M-MM-
##M-M--M-M--M---M-M-M-MM-
##M-M--M-M--M---M-M-M-MM-
-HM-M--M-M-#M---MHM-M-MM-
--M-MH-M-MH#M-H-M-M-M-MMH
--M-M--M-M-#M---M-MHM-MM-
--MHM--M-M-#MH--M-M-MHMM-
####M--M-M--##--M-M-##MM-