######-###--####M-M-####-
##M######M--M###M-M-M#MM-
--M######M--MH##MHM-MHMM-
--M######M--M-##M-M-M-MM-
--M---#--M--M---M-MHM-MM-
--M---#--M--M---M-M-M-MM-
--M---H--MH-M---M-M-M-MMH
--MH---H-M--M-H-M-M-M-MM-
DdM#---#-M--M-#-M-M-M-MM-
##M#---#-M--M-#-M-M-M-MM-
##M#---#-M--M-#-M-M-M-MM-
-HM#--##-M--M-#-MHM-M-MM-
--M#--##-MH-M-#-M-M-M-MMH
--M#--##-M--M-#-M-MHM-MM-
--M#Dd##DM--MH#DM-M-MHMM-
######-##M--####M-M-###M-