##--###---##############-
##--######DDDDDDDDDDDDDM-
--########-------------M-
--########-------------M-
--###--###-------------M-
--###--#---------------M-
--#----H---------------MH
--#--H---H-------------M-
DD#--#---#-------------M-
##H--#---#-------------M-
##---#---#-------------M-
-HH--#-###-------------M-
--####-###-------------MH
--####-###-------------M-
--####D###-------------M-
#######---#############M-