-#-#--#####-##-#M-M-#####
-M-#--######MM-#M-M-M#M#-
#M#H#-######MM-MMHM-MHMH-
#M#-#-######MM-MM-M-M-M--
#M#-#-#----#MM-MM-MHM-M--
#M#-#-#----#MM-MM-M-M-M--
#M#-#H-----HMMHMM-M-M-M--
#M#-#--H-H--MM-MM-M-M-M--
#M#-#--#-#--MM-MM-M-M-M--
HMH-H--#-#--MM-MM-M-M-M--
-M-----#-#--MM-MM-M-M-M--
HMH-H--#-#-#MM-MMHM-M-M--
#M#-#H##-#-#MMHMM-M-M-M--
#M#-#-##-#-#MM-MM-MHM-M--
#M#H#-##D#D#MM-MM-M-MHMH-
#####-#####-#M-#M-M-#####