######--########-########
######--########-D##DDD##
--------#########--#---##
--------DDDDDDDD#--#---##
------H---------#--##----
----------------#--#-----
----------------#--#-----
----------------#--#---H-
-----D----------#--##--#-
-----#----------H--#---#-
-----#-------------#---#-
-----H----------H--#---#-
----------------#------#-
------H---------#------#-
DDDDD-----------#------#D
######--#################