#####--###--#####-M-#####
##M#M-###M--M#####M-M#M##
--MHM-###M--MH####M-MHM##
--M-M-###M--M-####M-M-M##
--M-M-#--M--M----#MHM-M--
--M-M-#--M--M----#M-M-M--
--M-MHH--MH-M----HM-M-M--
--M-M--H-M--M-H---M-M-MH-
DdM-M--#-M--M-#---M-M-M#-
##M-M--#-M--M-#---M-M-M#-
##M-M--#-M--M-#---M-M-M#-
-HM-M-##-M--M-#--#M-M-M#-
--M-MH##-MH-M-#--#M-M-M#-
--M-M-##-M--M-#--#MHM-M#-
--MHM-##DM--MH#Dd#M-MHM#D
####M--##M--#####-M-#####