-#####--#########-----##-
-#####-##########-----###
-------##################
-------#DDDDDDDDD########
------H#---------#####--#
-------#---------#####--#
-------H----------#-#---H
------------------#-#-H--
#D---D------------#-#-#--
-#---#------------H-H-#--
-#---#----------------#--
TH---H-#----------H-H-#-#
T------#---------######-#
------H#---------######-#
--DDD--#---------######D#
-#####--################-