##-###--########------###
D#-###-#########------###
-------##################
-------#DDDDDDDD#########
#-----H#--------#######--
#------#--------#######--
#------H--------#-#-#----
#---------------#-#-#--H-
#D---D----------#-#-#--#-
##H--#----------H-H-H--#-
##H--#-----------------#-
#HH--H-#--------H-H-H--#-
--#----#--------########-
------H#--------########-
---DD--#--------########D
##-###--#################