##----M-M#########--M--M-
##----M-MDDDDDDDDD--M--M-
------M-M-----------MH-MH
------M-M-----------M--M-
------M-M---------H-M--M-
------M-M-----------M--M-
--DDDDM-M-----------M--M-
------#-M-----------M--M-
DD----M-M-----------M--M-
##----M-M-----------M--M-
##----M-M-----------M--M-
-H----M-M-----------MH-MH
------M-M-----------M--M-
------M-M---------H-M--M-
------M-M-----------M--M-
##----M-M#########--M--M-