######-###########-M---##
######-DDDDDDDDDDD-M-H-DD
-------------------M-----
-------------------M-----
-------------------MH----
-------------------M-----
-------------------M-----
-------------------M-----
DD---D-------------M-----
##---#-------------M-----
##---#-------------M-----
-H---H-------------M-----
-------------------M-----
-------------------MH----
--DDD--------------M-----
######-###########-M---##