##-###M-M#########-M-##M-
##-###M-MDDDDDDDDD-M-##M-
------M-M----------M-##MH
------M-M----------M-##M-
------M-M----------MH--M-
------M-M----------M---M-
------M-M----------M---M-
------#-M----------M-H-M-
D----DM-M----------M-#-M-
#-H--#M-M----------M-#-M-
#-H--#M-M----------M-#-M-
--H--HM-M----------M-#-MH
--#---M-M----------M-#-M-
------M-M----------MH#-M-
-D-DD-M-M----------M-#DM-
##-###M-M#########-M-##M-