######--##########-M--#--
######-###########-M--M--
-------###########-M--M--
-------#DDDDDDDDD#-M--M--
------H#-----------MH-M--
-------#-----------M--M--
-------H-----------M--MH-
-----------------H-M--M--
DD---D-----------#-M--M--
##---#-----------#-M--M--
##---#-----------#-M--M--
-H---H-#---------#-M--M--
-------#---------#-M--MH-
------H#---------#-MH-M--
--DDD--#---------#-M--M--
######--##########-M--M--