##-#-#############--M--M-
##-M-DDDDDDDDDDDDD--M--M-
---M----------------MH-MH
---M----------------M--M-
---M--------------H-M--M-
---M----------------M--M-
---MH---------------M--M-
---M----------------M--M-
DD-M----------------M--M-
##HM----------------M--M-
##HM----------------M--M-
-HHM----------------MH-MH
--#MH---------------M--M-
---M--------------H-M--M-
---M----------------M--M-
##-M-#############--M--M-