######-#########-########
###DD#-D########-D##DDD##
--------#########--#---##
--------DDDDDDDD#--#---##
----------------#--##----
----------------#--#-----
----------------#--#-----
----------------#--#---H-
DD---D----------#--##--#-
##---#----------H--#---#-
##---#-------------#---#-
-H---H----------H--#---#-
----------------#------#-
----------------#------#-
--D-------------#------#D
######-##################