##--#####################
##--##DDDDDDDDDDDDDDDDDDD
--####-------------------
--####-------------------
--###--------------------
--###--------------------
--#----------------------
--#--H-------------------
DD#--#-------------------
##H--#-------------------
##---#-------------------
-HH--#-------------------
--####-------------------
--####-------------------
--####-------------------
#########################