##-###-############M--#--
##-###-DDDDDDDDDD##M--M--
-----------------##M--M--
-----------------DDM--M--
------H------------MH-M--
-------------------M--M--
-------------------M--MH-
-------------------M--M--
DD---D-------------M--M--
##H--#-------------M--M--
##H--#-------------M--M--
-HH--H-------------M--M--
--#----------------M--MH-
------H------------MH-M--
---DD--------------M--M--
##-###-############M--M--