######--#-#####--####-###
######-###############D--
-------###############--T
-------#D#D###########---
------H#-#-----##----#---
-------#-------#-----#-##
-------H-------H-----H-##
---------H-H-----H-----##
DD---D---#-#-----#-----##
##---#---#-#-----#-------
##---#---#-#-----#-------
-H---H-#-#-#---###---#---
-------#-#-#---###---#---
------H#-#-#---###---#-H-
--DDD--#-#-#DDD###DDD#-##
######--#-#####--####-###