-######-#################
-#DDD####################
-#---####################
-#---###DDDDDDDDD########
#------#-----------------
#------#-----------------
#------H-----------------
#----H-----------H---H---
-----#-----------#---#---
-----#-----------#---#---
-----#-----------#---#---
-----#-#---------#---#---
-----#-#---------#---#---
DD---#-#---------#---#---
-----#D#---------#DDD#DDD
#######-#################