-#--##-#M--M--#-#######M-
-#--##-DM--M--M-##DDDDDM-
--------M--M--M--#-----MH
--------M--M--M--D-----M-
------H-MH-M--M--------M-
--------M--M--M--------M-
--DD----M--M--M--------M-
--------M--M--M--------M-
-D---D--M--MH-M-D------M-
-#---#--M--M--M-#------M-
-#---#--M--M--M-#------M-
-H---H--M--M--M-H------MH
--------M--MH-MD-------M-
------H-MH-M--M--------M-
----D---M--M--M--------M-
-#--##-#M--M--M-#######M-