-#--##-#M#########-MM----
-#--##-DMDDDDDDDDD-MM----
--------M---------HMMH---
--------M----------MM---T
------H-M----------MM---T
--------M----------MM---T
--DD----M---------#MM---T
--------M----------MM-DDD
-D---D--M----------MM----
-#---#--M----------MM----
-#---#--M---------HMM----
-H---H--M----------MMH---
--------M----------MM----
------H-M----------MM----
----D---M----------MM----
-#--##-#M#########-MM----