##---####################
##---DDDDDDDDDDDDDDDDDDDD
-------------------------
-------------------------
-------------------------
-------------------------
--DDD--------------------
-------------------------
DD-----------------------
##-----------------------
##-----------------------
-H-----------------------
-------------------------
-------------------------
-------------------------
##---####################