##--#####################
##--#DDDDDDDDDDDD########
--#-#------------########
--#-#------------########
--##---------------------
--##---------------------
--##---------------------
--##-------------H---H---
DD#--------------#---#---
##H--------------#---#---
##---------------#---#---
-HH--------------#---#---
--#--------------#---#---
--#DD------------#---#---
--#--------------#DDD#DDD
#########################