------------M------------
------------M---T--------
--#---------M------------
------------M------------
------#-----MH-----#-----
------------M------------
------------M---------#--
------------M------------
------------M------#-----
------------M------------
-------#----M------------
------------M------------
------------M----------#-
------------MH-----------
--------T---M------------
------------M------------