############------####-M-
############------####-M-
##-T########------####-M-
---T########--#---####-M-
---T----#-----#--------M-
---T----#-----#-T------M-
#--T----#-----#-T------M-
#--T----#-------T------M-
#--T----#--------------MH
#--T----#--------------M-
#----#-----------------M-
#----#-----------------M-
#---########------####-M-
#---########------####-M-
############------####-M-
############------####-M-