#####---------------M--#-
#####---------------M--M-
##-T#---------------M--M-
---T#---------------#--M-
---T--------#-------M--M-
---T----------------M--M-
#--T--#--------#----M--MH
#--T--#-----#--#-T--M--M-
#--T--#--------#-T--M--M-
#--T--#--T-----#-T--M--M-
#--------T--#----T--M--M-
#--------T----------M--M-
#---#----T----------M--MH
#---#---------------M--M-
#####---------------M--M-
#####---------------M--M-