###--------------#####--M
D##--------------#####--M
-----------------#####--M
--------------T--#####--#
------------T-T---------M
------------T-T---------M
------#-----TD----------M
------#---T-T-----------M
----###---T----T--------M
----###-T-T----T---#----M
----#---T-T----T---#----M
--###----------T---#----M
--###------------#####--M
--#--------------#####--M
--#--------------#####--M
###--------------#####--M