------------M------------
------------M---T--------
------------M------------
--T---------M------------
--T---#-----MH-----#-----
--T---------M------------
--T-H-------M---------#--
------------M------------
------------M------#-----
------------M------------
-------#----M------------
------------M------------
----H-------M----------#-
------------MH-----------
--------T---M------------
------------M------------