####---M--------------#--
####---M--------------M--
##-#---M--------------M--
---#---M--------------M--
-------M--------#---T-M--
-------M------------T-M--
#------M----#-------T-MH-
#------M-T---T------T-M--
#------M-T---T--#-----M--
#------M-T------------M--
#------M--------------M--
#------M--------------M--
#--#---M--------------MH-
#--#---M--------------M--
####---M--------------M--
####---#--------------M--