--###-------#--M-----M---
--###-------M--M-----M-T-
--###-------M--M-----M-T-
--###-------M--M-----M-T-
------------M--M---T-M-T-
------------M--M---T-M---
------------MH-M-----M---
-------T----M--M-----#-T-
#------T--T-M--M-----M-T-
#--#---T--T-M--M---T-M---
#--#---T--T-M--M-----M---
#--#------T-M--M-----M---
#-###-------MH-M-----M---
#-###-------M--M-----M---
#-###-------M--M-----M---
#-###-------M--#-----M---