#--------##########------
----#---------#####------
----#---------#####---###
----#---------#Dd##---###
----#---------#-------T##
--#H----------#-------T##
--#H----------#-------T--
--#H---T------#----------
#H##---T--#---#------H---
#H-----T--#--------------
#H-----T--#------T-------
##--------#---T----------
#----------------##------
#----------------##------
#----------------##------
#--------##########------