#########--#-------------
#########--#-----#-------
##-T#####--#-----#-------
---T#####--------#-------
---T-------------#-#-----
---T-----------#H--------
#--T-----------#H-----#--
#--T-----------#H--------
#--T-----------##--#-----
#--T---------#H----------
#----#-------#H----------
#----#-------#H----------
#---#####--#DD#--------#-
#---#####--#-------------
#########--#-------------
#########--#-------------