--##-M---------#########-
--##-M---------#########-
--##-M-#######-#####-----
--##-M-#######-#####-----
-----M-T######T------#---
-----M-T######T------#---
-----M-T------T------#---
#----M---T-----------#---
-----MH--T##---------##--
-----M---T##DD#--#---##--
-----M---T#####--#---##--
-----M---######--#---##-#
##-#-M-----#T#######-####
##-#-M------T--#####-###-
##-#-M------T--#########-
##-#-M---------#########-