#----------------------#-
----#------------------M-
----#------------------M-
----#--#-------#--#--T-M-
----#--#-T-----#--#--T-M-
--#H---#-T-----#--#--T-M-
--#H---#-T-----#--#--T-MH
--#H-----T-------------M-
#H##-------------------M-
#H---------------------M-
#H---------------------M-
##---------------------M-
#----------#-----------MH
#----------------------M-
#----------------------M-
#----------------------M-