###-M----T--M------------
###-M----T--M------------
#-T-M----T--MH-----------
--T-M----T--M------------
--T-M----T--M---------#--
--T-M----T--M--T---------
--T-M----T--M----T-------
--T-M----T--M----T--T----
----MH------M----T--T-#--
----M-------M----T--T----
----M-------M----T--T----
----M-------MH---T-------
----####----M----T-------
----M-------M----T-------
###-MH------M------------
###-M-------M------------