####--M--#----##########-
####--M--#----------####-
#-----MH-#----T--T----#--
------M--#---------#--#--
------M------------#--#--
--#---M----T----####-----
--#-#-M---------####-----
--#-#-M------T--####-----
--#-#-M------T######Dd--#
----#-M------T##----####-
------M------T------####-
------MH-----------T-H---
------M--#----T----T-----
------M--#----T-H-----T--
####--M--#----####----T--
####--M--#----##########-