------M--#T-############-
------M--#T-####Dd###----
------MH-#T-####---##----
------M--#T-####---##----
------M-----#--##--#-----
------M-----#--##--#--#--
----#-M--------##--#--#--
-T--#-M------H-##--#--#--
----#-M------#--##-#--##H
----#-M------#--##-#---#H
------M------#--##-#---#H
------MH-----#--##-#---##
------M--#--##--------##-
------M--#--##--------##-
------M--#--####------##-
------M--##-#########-##-