#####----------#######-M-
#####----------#######-M-
##-T#--#######-#######-MH
---T#--#######-#######-M-
---T---T######T--------M-
---T---T######T--------M-
#--T---T------T--------M-
#--T-----T-------------M-
#--T--H--T##-----------M-
#--T-----T##DD#--#-----M-
#--------T#####--#--T--M-
#--------######--#--T--MH
#---#------#T#######T#-M-
#---#-------T--#####T#-M-
#####-------T--#######-M-
#####----------#######-M-