#####-################-#-
#####--#########DD####-M-
##-T#--#########---T##-M-
---T#--#D##T####---T##-M-
---T---#---T-------T---M-
---T---#---T-----#-T---M-
#--T---#---T-----#-T---MH
#--T---#------T--#-T---M-
#--T---#------T--#-T---M-
#--T----------T----T---M-
#--------T----T--------M-
#------T------T--------M-
#---#----#####T#----##-MH
#---#----#####T#----##-M-
#####----#####T#######-M-
#####-################-M-