#####---------#--------#-
#####---------#-----#--M-
##-T#---------#-----#--M-
---T#---------------#--M-
---T--------#-------#--M-
---T--------------#H---M-
#--T--------------#H---MH
#--T---T----#-----#H---M-
#--T---T----------##---M-
#--T-----T------#H-----M-
#--------T--#---#H-----M-
#--------T------#H-----M-
#---#----T----#DD#-----MH
#---#---------#--------M-
#####---------#--------M-
#####---------#--------M-