#####-M---------#####----
D####-M-----------###----
--###-MH---T------M-M----
--###-M----T------M-M----
------M----T------M-M-T--
#-----M----T------M-M-T--
#-----###---------M-M-T--
#-----M------#--#-M-M----
#-----M------##-#-M-M----
------M-------H-#-M-M----
---#--MH---T-#H-#-M-M----
---#--M----T-#H-#-M-M----
--###-M----T-####-M-#----
--###-M----T-####-M-#----
#####-M------####-M-#----
#####-M------########----