#########--###---#---####
#########--#######---####
#########--##############
-----####--######-#######
-----------#--###-####--#
------T----#--#---####--#
#-------------H----#----#
#-----------H---H--#--H-#
#-----------#---#--#--#--
#------#----#---#--H--#--
#-T----#----#---#-----#--
#-T----#----#-###--H--#--
#-----###--##-###-#####--
#-----###--##-###-#####--
#########--##D###########
#########--###---########