-----------#--#--------M-
----T------M--M--------M-
-----------M--M------#-MH
-----------M--M--------M-
-----------M--M--------M-
--T--------M--M--------M-
--T---#-#--MH-MH-------M-
--T---#----M--M---#----M-
------#----M--M---#----M-
#-----#----M--M---#----M-
#----------M--M---#----M-
#----------M--M---#----MH
#----------MH-MH--#----M-
-----------M--M--------M-
-----------M--M--------M-
-----------M--M--------M-