#-M----------------M---M-
#-M-------T--------M---M-
T-M-------T--------M---MH
--M-------T--------M---M-
--M-------T--------MH--M-
--M----------------M---M-
--MT---------------M---M-
--MT------T--------M---M-
--MT------T--------M---M-
--MT-------------#-M---M-
--MT--------T----#-M---M-
--MT-------------#-M---MH
--MT-----------T-#-M---M-
--MT-----------T---MH--M-
D-M------------T---M---M-
#-M------------T---M---M-