###-#-------M----T-#-----
--#-M-------M---#T-M-----
----M-------MH---T-M-----
----M-------M----T-M-----
#---M-----T-M------M-----
#---M-----T-M------M-----
#---MH----T-###----MH-#--
#---M-----T-M------M--#--
#---M-------M------M--#--
#---M-------M------M--#--
#---M-------MH-----M-----
#---M-------M------M-----
###-MH------M------MH----
###-M--#----M------M-----
###-M-------M------M-----
###-M-------M------M-----