#-----######--------#--M-
------######--------#--M-
------M----M--#-----#--M-
------M----M--#-----#--M-
------M----M--T--------MH
--#H--M----M--T--------M-
--#H--M----M--T--------M-
--#H--M----M-----------M-
#H##--M----M-H---------M-
#H----M----M-----------M-
#H--T-M----M-----------M-
##--T-M----M-----------M-
#---T-M----#-----------M-
#---T-M----#------#-T--MH
#---##M----#--------T--M-
#---########--------T--M-