--T-###---------#####----
--T-#DD-----------###----
--T-#------T------M-M----
--T-#------T------M-M----
--T#-------T------M-M-T--
--T#-------T------M-M-T--
---#----#---------M-M-T--
---#----#----#--#-M-M----
--T-----#----##-#-M-M----
--T-----#-----H-#-M-M----
--T--------T-#H-#-M-M----
--T--------T-#H-#-M-M----
--T--------T-####-M-#----
--TDD------T-####-M-#----
--T----------####-M-#----
--T####------########----