#---######----#-------#--
#H--######----#-----#-M--
#---######----#-----#-M--
#---######----------#-M--
--------#---#-------#-M--
--------#---------#H--M--
--------#---------#H--MH-
--------#---#-----#H--M--
--------#---------##--M--
--T-----#-------#H----M--
--T--#------#---#H----M--
--T--#----------#H----M--
#-T-######----#DD#----MH-
#---######----#-------M--
#---######----#-------M--
#---######----#-------M--