---########-M--M-M----M--
---########-M--M-M---#M--
###########-M--M-M----MH-
###########-M--M-M----M--
####--------M--M-M----M--
####--T-----M--M-M-T--M--
-#----------M--M-M-T--M--
-#--H-------M--M-M----M--
-#--#-------M--M-M----M--
-H--#--#----M--M-M-T--M--
----#--#-T--M--M-M-T--M--
-H--#--#-T--M--M-M----MH-
#####-###T#-M--M-M----M--
#####-###T#-M--M-M----M--
###########-M--M-M----M--
###########-#--#-M----M--