---###---##------T-M-#---
---########-----#T#M-#---
###########------T-M-#---
#########-#------T-M-----
####--###----------M-----
####--#------------M-----
-#----H------------M-----
-#--H---H----------M-----
-#--#---#----------M-----
-H--#---#----#-----M---#H
----#---#----#-----M---#H
-H--#-###----#-----M---#H
#####-###----#-----M-#Dd#
#####-###----------M-#---
###########--------M-#---
######---##--------M-#---