---#--M-------------M--#-
---M--M-------------M--M-
---M--M-------------M--M-
---M--M-------------#--M-
---M--M------H------M--M-
---M--M-------------M--M-
---MH-M-------------M--MH
---M--M----------T--M--M-
---M--M----------T--M--M-
---M--M-T--------T--M--M-
---M--M-T--------T--M--M-
---M--M-T-----------M--M-
---MH-M-T-----------M--MH
---M--M------H------M--M-
---M--M-------------M--M-
---M--M-------------M--M-