T############-T##########
T#DDD#####-##-T######--##
T#---#####----T######--##
T#------##----T######--##
T------###----T##--#-----
T------###----T#---------
T------###----T#------T--
T------###----T#-------H-
T------##-----T#-------#-
T-------#-----T--------#-
--------#--------------#-
--------##-------------#-
-------###-##----------#-
-D-----###-##----------#-
-------###D##----------#D
-############----------##