#-----M-M--#---------M---
#-----M-M--M---------M---
-#----M-M--M---------M---
------M-M--M------T--M---
------M-MH-M--T---T--M---
------M-M--M--T---T--M---
-#----M-M--MH-TH--T--M---
------#-M--M--T------#---
------M-M--M---------M---
#-----M-M--M------T--M---
##----M-M--M------T--M---
------M-M--M------T--M-#-
---#--M-M--MH--H--T--M---
------M-MH-M---------M---
------M-M--M---------M---
------M-M--M---------M---