#---#----#-----###-M-#---
----M----M-----###-M-#---
----M----M-----###-M-#---
----M----M-----###-M-----
----M--T-M-----#---M-----
--#-M--T-M---------M-----
--#-MH-T-MH-T------M-----
--#-M--T-M--T-#----M-----
#H#-M--T-M--T-#--#-M-----
#H--M--T-M--T-#--#-M---#H
#H--M--T-M--T-#--#-M---#H
##--M----M--T-#--#-M---#H
#---MH---MH-T----#-M-#Dd#
#---M----M--T----#-M-#---
#---M----M-------#-M-#---
#---M----M-------#-M-#---