##---------#-####-M--#---
-#---------#-#####M--#---
-#---------#######M--#---
-###----#---######M------
-###----#---##---#MH-----
---#----#---##---#M------
---#Dd#-#--------HM------
---####-------H---M------
--------------#---M------
--------------#---M----#H
--------------#---M----#H
------T-------#--#M----#H
##----------###--#M--#Dd#
##----------###--#MH-#---
-#---------####Dd#M--#---
-#---------######-M--#---