###---#######-#--------#-
###---###DDD#-M--------M-
###---###-----M--------M-
###---###-----M-----T--M-
-#------#-----M-----T--M-
-#------#-----M-----T--M-
-#------#-----MH----T--MH
-#------#-----M---#----M-
-#------------M---#----M-
-#--T---------M---#-T--M-
----TH--------M---#-T--M-
----T---------M---#-T--M-
###---#######-MH--#-T--MH
###---#######-M--------M-
###---#######-M--------M-
###---#######-M--------M-