#---###---####------M--#-
#---##########------M--M-
##############------M--M-
-#########---#------#--M-
-####--###----------M--M-
-####--#------------M--M-
--#----H------------M--MH
--#--H---H-------T--M--M-
--#--#---#-------T--M--M-
--H--#---#-------T--M--M-
-----#---#-T-----T--M--M-
--H--#-###-T--------M--M-
-#####-###----------M--MH
-#####-###----------M--M-
######D#######------M--M-
#######---####------M--M-