--#---####---##-M-----###
###---#########-M-----###
###############-M--------
##-##########-#-M-T------
##-####---###---M-T------
---####---#-----M-T------
----#-----H-----M-T-T----
-H--#--H----H---M---T--#-
-#--#--#----#---M---T--#-
-#--H--#----#---M-T-T--#-
-#-----#----#---M-T----#-
##--H--#--###---M-T----T-
##-#####--###---M-T----T-
##-#####--###---M------T-
########Dd#####-M-----##D
--########---##-M-----###