###---####---##-----#----
###---#########-----M-###
###############-----M-###
---##########-#---T-M-###
---####---###-----T-M-###
---####---#-------T-M-#--
----#-----H-------T-M-H--
----#--H----H---T---M---H
----#--#----#---T---M---#
----H--#----#---T-T-M---#
-T-----#----#-----T-M---#
-T--H--#--###-----T-M-###
---#####--###-----T-M-###
---#####--###-------M-###
########Dd#####-----M-###
##########---##-----#----