-###----------#----M---M-
-#D#----------M----M---M-
-#------------M----M---MH
-#------------M----M-T-M-
#-------------M----M-T-M-
#-------------M----M-T-M-
#-----------#-MH---M-T-M-
#------T------M----M---M-
-------T------M----M---M-
---------T----M--#-M---M-
---------T----M--#-M---M-
---------T----M--#-M-T-MH
---#-----T----MH-#-M---M-
DD-#----------M----M---M-
---#----------M----M---M-
####----------M----M---M-