#---#----#--#--M-M----###
----M----M--M--M-M----###
----M----M--M--M-M----###
----M----M--M--M-M----###
----M----M--M--M-M-----#-
--#-M----M--M--M-M-T---#-
--#-MH-#-MH-MH-M-M-T---#-
--#-M--#-M--M--M-M-----#-
#H#-M--#-M--M--M-M-----#-
#H--M--#-M--M--M-M-T---#-
#H--M----M--M--M-M-T-----
##--M----M--M--M-M-------
#---MH---MH-MH-M-M----###
#---M----M--M--M-M----###
#---M----M--M--M-M----###
#---M----M--M--#-M----###