#########TM-####-T-M--M--
#Dd####--TM-##Dd#T#M--M--
#--####--TM-##---T-M--M--
#----##--TM-##---T-M--M--
----###--TM--#-----MH-MH-
----###--TM--#-----M--M--
----###---M--#-----M--M--
----###---M--#-----M--M--
----##----MH-------M--M--
-----#----M--------M--M--
-----#----M--------M--M--
-----##---M--------M--M--
----###---MH####---M--M--
d---###---M-####---MH-MH-
----###Dd#M-####---M--M--
##########M-####---M--M--