#####-########--T-#######
#####--#######--T-#DDDDDD
#####--#######--T-#------
#####--#D##T##--T-#------
-#-----#---T----T#-------
-#-----#---T----T#-------
-#-----#---T-----#-------
-#-T---#---------#-------
-#-T---#--------T--------
-#-T------------T--------
---T-----T------T--------
---T---T--------T--------
###T#----#####--T--------
###T#----#####--TDD------
###T#----#####--T--------
#####-########--T########