------####---####---#-###
------###########---#-###
#################---#-###
#############-###---#-###
#######---###----T---T#--
#######---#----T-T---T#--
#-#-#-----H------T---T---
#-#-#--H----H----T---T-H-
#-#-#--#----#----------#-
H-H-H--#----#---#------#-
-------#----#---#------#-
H-H-H--#--###---#------#-
########--###--##---#-##-
########--###--##---#-##-
########Dd#######---#-##D
##########---####---#-###