-------------------------
-------------------------
-------------------------
-------------------------
-------------------------
--------------E----------
-------------<>----------
-------------[]----------
-------------[]---o------
------------SXXS---------
-------------------------
-------------------------
-------------------------
XXXXXXXXXXXXXXXXXXXXXXXXX