-------------------------
-------------------------
-------------------------
-------------------------
-------------------------
-----XX-----------XXX----
----XXX----------XXXX----
---XXXX---------XXXXX----
--XXXXX--------XXXXXX----
--XXXXX--------XXXXXX----
XXXXXXX------XXXXXXXX----
XXXXXXX-----XXXXXXXXX----
--XXXXX--------XXXXXX----
XXXXXXXXXXXXXXXXXXXXXXXXX