-------------------------
-------------------------
-------------------------
-------------------------
-------------------------
----SSSS--------SSSSS----
-------------------------
-------------------------
--------------SS---------
-------------------------
-------------------------
-------------------------
-----------------------EE
--XXXX---X-XXXXXX-----XXX