-------------------------
-------------------------
-------------------------
-------------------------
-------------------------
-------------------------
-------------------------
-------------------------
-------E---oo----------Q-
--E---<>--------------E--
-<>---[]---------X----E--
-[]---[]---------X-------
-[]---[]---------X-------
XXX---XXXX-------XXXXXXXX