-------------------------
-------------------------
-------------------------
-------------------------
-------------------------
S------------------------
-------------------------
----------oo-------------
-EE----------------------
---XX-XXX------------XX--
---XX-XXX------------XX--
---XX-XXX------------XXX-
---X--XXX------E-E-E-XXX-
---X--XX---XXXXXXXXXXXXXX