-------------------------
-------------------------
-------------------------
-------------------------
-------------------------
SSSSSSSSSSS---------SSSSS
-------------------------
-------------------------
-------------------------
-------------------------
-------------------------
-------------------------
----------------E--------
X---XX------XXXXXXXXX----