-------------------------
-------------------------
-------------------------
-------------------------
-------------------------
-------------------------
-------------------------
-------------------------
-------------------EE----
X----------XX--------XX-X
-----------XX--------XX-X
-----------XX--------XX-X
----E-EE---XX--------X--X
XXXXXXXXX--XX--XXX---X--X