-------------------------
-------------------------
-------------------------
-------------------------
-------------------------
S------------------------
-------------------------
-------------------------
-EE-----E----------------
---XX-X<>----------------
---XX-X[]--E-------------
---XX-X[]-<>-------------
---X--X[]-[]------E-EE-EE
---X--XXXXXXXXXXXXXXXXXXX