-------------------------
-------------------------
-------------------------
-------------------------
-------------------------
--------------------SSSSS
-------------------------
-------------------------
------------------SS-----
----------E--------------
---------<>--------------
---------[]--------------
---------[]--------------
--------XXXXXX-XXXXXX----