-------------------------
-------------------------
-------------------------
-------------------------
-------------------------
-------------------S-----
-------------------------
-XSS---------------------
XXX---------------E-EE---
XXX-S-----------------XX-
XXX------------X------XX-
XXX------------X------XX-
XXX---E--------X------X--
XX---XXXXXXXXXXX------X--