-------------------------
-------------------------
-------------------------
-------------------------
-------------------------
S--------------------SSSS
-------------------------
-------------------------
-----------o-------------
XX----------X------------
------------XX-E---------
------------XX-----------
--------E---X------------
----X-XXXX--X---XXXXXX---