-------------------------
-------------------------
-------------------------
-------------------------
-------------------------
S--SSSSSSSSSSSSQS---SSSSS
-------------------------
-------------------------
-EE------E--------SS-----
--------SSSSSSSSS--------
-------------------------
-------------------------
-------------------------
--------XXXXXXXXXXXXX----