-------------------------
-------------------------
-------------------------
-------------------------
-------------------------
--------------------SSSSS
-------------------------
-------------------------
------------------SS-----
-------------------------
-------------------------
-------------------------
--------------EE---------
--------X--XXXXXXXXXX----