-------------------------
-------------------------
-------------------------
-------------------------
-------------------------
--SSSSSSS-----------SSSSS
-------------------------
-------------------------
------------------SS-----
-------------------------
-------------------------
-------------------------
---------EEEE-EE---------
XX-------XXXXXXXXXXXX----