-------------------------
-------------------------
-------------------------
-------------------------
-------------------------
----------------SSSSSSSSS
-------------------------
-------------------------
--------------SS---------
-------------------------
-------------------------
-------------------------
-------------------------
--------X-XXXXXXX--------