-------------------------
-------------------------
-------------------------
-------------------------
-------------------------
--SS------S-XX----S------
------------XX-----------
------------XX-----------
---E-----E--XX---E-EE----
-SSS--------XX-----------
------------XX-----------
------------XX-----------
-------E----XX-----------
-XXX-XXX----XXX------XXXX