-------------------------
-------------------------
-------------------------
-------------------------
-------------------------
--SSSSSSS-------SSSSS----
-------------------------
-------------------------
SQ-------------S-----E---
--------------------->---
------------E--------]---
---------------------]---
SS-------------------]---
----------XXXXXXX----X--X