-------------------------
-------------------------
-------------------------
-------------------------
-------------------------
--SSSSSSS-------SSSSSSS--
-------------------------
-------------------------
-------------SSS---------
-------------------------
-------------------------
-------------------------
EE-------EE------------EE
XX-------XXXXXXXX---X--XX