-------------------------
-------------------------
-------------------------
-------------------------
-------------------------
------------------S------
-------------------------
-------------------------
-----------------E-EE----
------------Q--------XX-X
---------------------XX-X
---------------------XX-X
---------------------X--X
-------XXXXXXXX------X--X