-------------------------
-------------------------
-------------------------
-------------------------
-------------------------
--------XXXX-------------
--------XXXX-------------
--------XXXX-------------
EE-----oXXXXo------SS-SQ-
--X-----XXXX-------X-----
--X-----XXXX---XXX-X-----
--X-----XXXX---XXXXX-----
--X-----XXXX---X--XX--SSS
--XX----XXXX--X---X------