-------------------------
-------------------------
-------------------------
-------------------------
-------------------------
SSSSSS----------SSSSSSSSS
-------------------------
-------------------------
--------------SS---------
-------------------------
-------------------------
-------------------------
--------EEEEE------------
-------XXXXXXXXXX--------