-------------------------
-------------------------
-------------------------
-------------------------
-------------------------
S-------------------SSSSS
-------------------------
-------------------------
-EE---------------SS-----
---XX-X------------------
---XX-X------------------
---XX-X------------------
---X--X------------------
---X--X---------XXXXX----