-------------------------
-------------------------
-------------------------
-------------------------
-------------------------
SSSSSSSS--------S---SSSSS
-------------------------
-------------------------
-----------------EE------
-------------------------
-------------------------
-------------------------
---------EE--------E-----
X--------XXXXX-----XX----