-------------------------
-------------------------
-------------------------
-------------------------
-------------------------
--SSSSSSS-------SS--SSSSS
-------------------------
-------------------------
SQ----------------E------
-------------------------
-------------------------
-------------------------
SS-------EEEE-EE---E-----
---------XXXXXXXX--XX----