-------------------------
-------------------------
-------------------------
-------------------------
-------------------------
SSSSSSSSSSS--------S-----
-------------------------
-------------------------
------------------E-EE---
----------------------XX-
----------------------XX-
----------------------XX-
-------------E--------X--
X-----------XXX-------X--