-------------------------
-------------------------
-------------------------
-------------------------
-------------------------
----------S--------------
------------------------E
-----------------------<>
-EE------E-E-----------[]
X--XX-X----------------XX
---XX-X------------------
---XX-X------------------
---X--X------------------
---X--X----------X----XXX