-------------------------
-------------------------
----------E--------------
-------------------------
-------------------------
XX-----------------------
XX-----------------------
XX-----------------------
XX-----------------------
XX-----------------------
XX--------------E--------
XX-------------<>--------
XX--------XX---[]--------
XXXXXXXXXXXXXXXXXXXXXXXXX