-------------------------
-------------------------
-------------------------
-------------------------
-------------------------
S---------S--------------
-------------------------
-------------------------
-EE------E-EE------------
---XX-X------XX-X--------
---XX-X------XX-X-------E
---XX-X------XX-X--------
---X--X------X--X--------
---X--X------X--X------X-