-------------------------
-------------------------
-------------------------
-------------------------
-------------------------
-----SS-----------S---SSS
-------------------------
-------------------------
-------------o---E-EEE---
----XXXX-----------------
-XXXXX-------------------
XXXX---------------------
XX-----------------------
------XX-----------------