-------------------------
-------------------------
-------------------------
-------------------------
-------------------------
----SSSSS----------S-----
-------------------------
-------------------------
---E--------------E-EE---
X---------------------XX-
----------------------XX-
----------------------XX-
----------------------X--
----------X-----------X--