-------------------------
-------------------------
-------------------------
-------------------------
-------------------------
S-SSSS----------S-S---SSS
-------------------------
-------------------------
-E---------------E-EEE---
-------------------------
-------------------------
-------------------------
--------EEEEE-EE---------
-------XXXXXXXXX---------