-------------------------
-------------------------
-------------------------
-------------------------
-------------------------
--SSSSSSS-S-----S----SS--
-------------------------
-------------------------
---------E-EE--E-EE-E----
--------S----------------
-------------------------
-------------------------
EE-----------------E---EE
XX------X----XX----X---XX