-------------------------
-------------------------
-------------------------
-------------------------
-------------------------
S---S---S---------S------
--------------E----------
-------------->----------
-EEE-------EE-]--E-EEE---
-------------XX-------XX-
-------------X--------XX-
-------------X--------XX-
-------E-----X--------X--
-----XXX--X--XX-------X--