-------------------------
-------------------------
-------------------------
-------------------------
-------------------------
S-SSSS----------S-----SSS
-------------------------
-------------------------
-E-------------E-EEEEE---
-------------------------
-------------------------
-------------------------
--------EEEEE------------
-------XXXXXXX-----------