-------------------------
-------------------------
-------------------------
-------------------------
-------------------------
S---S--SS---------S--SSSS
-------------------------
-------------------------
-EEE-EE----------E-EE----
-------------------------
-------------------------
-------------------------
---------EEEE------------
---------XXXXX-----------