-------------------------
-------------------------
-------------------------
-------------------------
-------------------------
S--S------S--------S--SSS
-------------------------
-------------------------
-EE-EE---E-EE-----E-EE---
------X------------------
------X------------------
------X------------------
------X------E-----------
------X------XX-------X--