-------------------------
-------------------------
-------------------------
-------------------------
-------------------------
----S-SSSSS-----S-S------
-------------------------
-------------------------
-EEE-E---------E-E-EEEQ--
-------------------------
-------------------------
-------------------------
E---------------------SSS
X-----------X------------