-------------------------
-------------------------
-------------------------
-------------------------
-------------------------
----S-----S-----S-S------
-------------------------
-------------------------
---E-EE--E-EE--E-E-EEE---
X------------XX-------XX-
-------------XX-------XX-
-------------XX-------XX-
-------------X--------X--
-------------X--------X--