-------------------------
-------------------------
-------------------------
-------------------------
-------------------------
---S------S-----S--S-----
-------------------------
-------------------------
SEE-EE---E-EEo-E-EE-EE---
------X---------------XX-
------X---------------XX-
------X---------------XX-
S-----X---------------X--
------X---------------X--