-------------------------
-------------------------
-------------------------
-------------------------
-------------------------
------------------XXX----
-----------------XXXX----
----------------XXXXX----
---------------XXXXXX----
---------------XXXXXX----
------X------XXXXXXXX----
------X-----XXXXXXXXX----
------X--------XXXXXX----
----XXXXXXXXXXXXXXXXXXXXX