-------------------------
-------------------------
-------------------------
-------------------------
-------------------------
XXX----------SSSS----SSSS
XXX----------------------
XXX----------------------
XXX-----oo---------------
XXX-------------ES-------
XXX------------<>--------
XXX------------[]--------
XXX------------[]--------
XXXXXXXXXXXXXXXXXXXXXX---