-------------------------
-------------------------
-------------------------
-------------------------
-------------------------
--------------------XX---
--------------------XX---
--------------------XX---
--------------------XX---
----------E---------XX---
---------<>---------XX---
---------[]--------------
---------[]-EE-----------
XX-XXXXXXXXXXXXXXXXXXXXXX