-------------------------
-------------------------
-------------------------
-------------------------
-------------------------
--SSSSSSSSS--------------
-------------------------
-------------------------
-------------------------
-------------------------
------------------------X
----------------X-------X
----------------X-------X
XXXXXX------XXXXXXXXXXXXX