-------------------------
-------------------------
-------------------------
-------------------------
-------------------------
S--XXX--------------SSSSS
--XXXX-------------------
-XXXXX-------------------
-XXXXX------------SS-----
-XXXXX-------------------
-XXXXX-------------------
-XXXXX-------------------
-XXXXX-------------------
-XXXXXXXXXXXXXXXXXXXX----