-------------------------
-------------------------
-------------------------
-------------------------
-------------------------
-------------------------
----------------------XSS
---------------------XXX-
--------------------XXXS-
-------------------XXXXX-
------------------XXXXXX-
-----------------XXXXXXX-
----------------XXXXXXXX-
------XXXXXXXXXXXXXXXXXXX