-------------------------
-------------------------
-------------------------
-------------------------
-------------------------
S------------------------
-------------------------
---------------X---------
--------------XX---------
XX-----------XXX---------
------------XXXX---------
-----------XXXXX---------
----------XXXXXX---------
----XXXXXXXXXXXXXXXXX-XXX