-------------------------
-------------------------
-------------------------
-------------------------
-------------------------
SSS----------------------
-------------E-----------
------------<>-----------
-------E----[]-----------
------<>----[]--------E--
-E----[]--E-[]-----XX<>--
------[]-<>-[]-----XX[]--
------[]-[]-[]-----XX[]-E
XXXXXXXXXXXXXXXXXXXX-XXXX