-------------------------
-------------------------
-------------------------
-------------------------
-------------------------
-XX----------------XX----
XXX----------------XX----
XXX-------------XX-XX----
XXX-------------XX-XX----
XXX-------------XX-XX----
XXX------------XXX-XX---E
XXX------------XXX-XX----
XXX------------XXX-XX----
XXXXXXX--XXXXXXXXX-XX--X-