-------------------------
-------------------------
-------------------------
-------------------------
-------------------------
-------------XX------SSSS
------------XXX----------
-----------XXXX----------
----------XXXXX----------
----------XXXXX-----X----
--------XXXXXXX-----X----
-------XXXXXXXX-----X----
----------XXXXX-----X----
-----XXXXXXXXXXXXXXXXXX--