-------------------------
-------------------------
-------------------------
-------------------------
-------------------------
--SSSSSSSSS--------XXX---
-------------------XXX---
-----------------X-XXX---
-----------------X-XXX---
-----------------X-XXX---
-X---------------X-XXX---
XX---------------X-XXX---
XX---------------X-XXX---
XXXXXX------XXXXXX-XXXXXX