-------------------------
-------------------------
-------------------------
-------------------------
-------------------------
-------------------------
---------------------E---
--------------------<>---
----------------oo--[]---
X-------------------XXX--
-------------------------
-------------------------
------XX--X--------------
X--XXXXXXXXXXXX----XXXXXX