-------------------------
-------------------------
-------------------------
-------------------------
-------------------------
------SSSSS-----XXXX-----
---------------XXXXX-----
--------------XXXXXX-----
--------------XXXXXX-----
--------------XXXXXX-----
--------------XXXXXX-----
--------------XXXXXX-----
-S------------XXXXXX---E-
XXXXXX------XXXXXXXXXXXXX