-------------------------
-------------------------
-------------------------
-------------------------
-------------------------
-------------------------
-------------------------
-------------------------
-----------------------E-
-X--------E-----------<>-
XXX------<>-----E-----[]-
XXX------[]----<>-----[]-
XX-------[]----[]-E---[]-
XX---XXXXXXXXXXXXXXXXXXXX