-------------------------
-------------------------
-------------------------
-------------------------
-------------------------
-------------------XXX---
-------------------XXX---
----------------XX-XXX---
----------------XX-XXX---
----------------XX-XXX---
---------------XXX-XXX---
---------------XXX-XXX---
---------------XXX-XXX---
-------XXXXXXXXXXX-XXXXXX