-------------------------
-------------------------
-------------------------
-------------------------
-------------------------
--------EXXX---------SSSS
---------XXX-------------
-X-------XXX-------------
XX------EXXXo------------
XX-----<>XXX-------------
XX-----[]XXX---E---------
XX----X[]XXX-------------
XX---XX[]XXX-------------
XXXXXXXXXXXX--X-XXXXXX---