-------------------------
-------------------------
-------------------------
-------------------------
-------------------------
-------------------------
-------------------------
-------------------------
-----------------Q-------
X---------------E--------
----------------E--------
-------------------------
----E-EE--EE-E-----------
XXXXXXXXXXXXXXXXXXXXXXX--