-------------------------
-------------------------
-------------------------
-------------------------
-------------------------
---------------------SSSS
-------------------oo----
-------------X-----------
-------E-----X---E-------
--E---<>---Q-X--<>-------
-<>---[]-----X--[]-------
-[]---[]-----X--[]-------
-[]---[]-----X--[]-------
XXX---XXXXXXXXXXXXXXXX---