-------------------------
-------------------------
-------------------------
-------------------------
------------------E------
SSSSSSSSSSSSSSSQSSS--XX--
--------------------XXX--
-------------------XXXX--
---------E---------XXXX--
--------SSSSSSSSSSSXXXX--
-------------------XXXX--
-------------------XXXX--
-------------------XXXX--
X-------XXXXXXXXXXXXXXXXX