-------------------------
-------------------------
-------------------------
-------------------------
-------------------------
-------------------------
-------------------------
----------------------X--
---------------------XX--
--------------------XXX--
-------------------XXXX--
------------------XXXXX--
-----------------XXXXXX--
--------X-XXXXXXXXXXXXXXX