-------------------------
-------------------------
-------------------------
-------------------------
-------------------------
S--------------------SSSS
-------------------------
-------------------------
-EE----------------------
---XX-XX----S--<---------
---XX-XX-------[---------
---XX-XX-------[---------
---X--XX-------[---------
---X--XXXXXXXXXXXXXXXX---