-------------------------
-------------------------
-------------------------
-------------------------
-------------------------
--SSSS--------------SSSSS
------------oo-----------
-o-----------------------
-------------------------
S------------------X-----
-------------------X-----
SS-----------------X-----
----------------E--X-----
-------XXXXXXXXXXXXXXX---