-------------------------
-------------------------
-------------------------
-------------------------
-------------------------
-----------------XXX-----
-----------------XXX-----
-----------------XXX-----
EE-------E-------XXX-----
--XX-X--<>-------XXX-----
--XX-X--[]-----E-XXX---E-
--XX-X--[]-------XXX--<>-
--X--X--[]-------XXX--[]-
--X--X--XXXXXXX-XXXXXXXXX