-------------------------
-------------------------
-------------------------
-------------------------
-------------------------
----------------SSSSS----
-------------------------
-------------------------
--------------SS---------
-------------------------
----------X--------------
----------X--------------
----------X--------------
-------XXXXXXXXXX-----XXX