-------------------------
-------------------------
-------------------------
-------------------------
-------------------------
---------------------SSSS
-------------------------
-o-----------------------
---------E---------------
S----X--<>---------------
-----X--[]-----E---------
SSS--X--[]---------------
-----X--[]---------------
---X-X--XXXXXXX-XXXXXX---