-------------------------
-------------------------
-------------------------
-------------------------
-------------------------
--S----------------------
-------------------oo----
------X------------------
------X----oo----E-------
--XX--X---------->-------
------X--------E-]-------
------X----------]-------
X-----X----------]-------
XXXX--X-------X-XXXXXXXXX